time,temperature_2m (°F),cloudcover (%),cloudcover_low (%),cloudcover_mid (%),cloudcover_high (%),shortwave_radiation (W/m²),direct_radiation (W/m²),diffuse_radiation (W/m²),direct_normal_irradiance (W/m²)
2022-04-01T00:00,56.3,37,6,23,60,3,1,2,6.7
2022-04-01T01:00,54.5,27,4,17,44,0,0,0,0
2022-04-01T02:00,48.8,37,25,21,7,0,0,0,0
2022-04-01T03:00,44.8,72,47,48,2,0,0,0,0
2022-04-01T04:00,42.7,100,86,65,0,0,0,0,0
2022-04-01T05:00,41.9,100,82,56,0,0,0,0,0
2022-04-01T06:00,41.3,100,75,53,2,0,0,0,0
2022-04-01T07:00,41.2,77,37,62,21,0,0,0,0
2022-04-01T08:00,39.8,100,48,94,54,0,0,0,0
2022-04-01T09:00,38.9,100,92,90,7,0,0,0,0
2022-04-01T10:00,38.2,100,80,84,6,0,0,0,0
2022-04-01T11:00,37.6,56,8,80,1,0,0,0,0
2022-04-01T12:00,38.5,62,18,77,0,45,14,31,0
2022-04-01T13:00,39.9,81,33,86,0,132,31,101,106.3
2022-04-01T14:00,40.3,84,42,77,0,223,84,139,138.1
2022-04-01T15:00,41.8,87,47,74,0,304,100,204,171
2022-04-01T16:00,42.6,95,45,87,6,394,142,252,173.6
2022-04-01T17:00,43.3,100,79,85,11,500,250,250,258.3
2022-04-01T18:00,44.3,100,72,89,0,565,284,281,347.8
2022-04-01T19:00,43.5,100,69,86,0,569,243,326,346.9
2022-04-01T20:00,42.7,100,80,69,0,463,199,264,314.4
2022-04-01T21:00,41.3,80,37,77,1,352,149,203,287.3
2022-04-01T22:00,40,100,48,90,36,268,147,121,348.3
2022-04-01T23:00,38,100,48,73,81,104,40,64,324.9
2022-04-02T00:00,36.1,100,62,68,14,7,1,6,45.4
2022-04-02T01:00,34.8,98,73,53,0,0,0,0,0
2022-04-02T02:00,34.2,62,55,21,0,0,0,0,0
2022-04-02T03:00,33.3,63,63,11,0,0,0,0,0
2022-04-02T04:00,32.9,63,67,4,0,0,0,0,0
2022-04-02T05:00,32.5,55,61,0,0,0,0,0,0
2022-04-02T06:00,32.2,61,68,0,0,0,0,0,0
2022-04-02T07:00,31.8,56,62,0,0,0,0,0,0
2022-04-02T08:00,31.6,48,53,0,0,0,0,0,0
2022-04-02T09:00,31.3,38,42,0,0,0,0,0,0
2022-04-02T10:00,31.1,59,65,0,0,0,0,0,0
2022-04-02T11:00,30.9,48,53,0,0,1,0,1,0
2022-04-02T12:00,31.7,54,60,0,0,82,50,32,0
2022-04-02T13:00,33.3,70,78,0,0,236,152,84,442.2
2022-04-02T14:00,35.7,90,100,0,0,396,256,140,514.1
2022-04-02T15:00,38,92,100,0,6,536,323,213,516.4
2022-04-02T16:00,40.8,93,82,0,63,719,575,144,649.7
2022-04-02T17:00,43.2,79,64,0,71,827,697,130,855.1
2022-04-02T18:00,44.5,9,0,0,31,772,669,103,870.2
2022-04-02T19:00,45.9,0,0,0,0,798,698,100,888
2022-04-02T20:00,46.8,6,0,0,21,694,608,86,934.9
2022-04-02T21:00,46.9,21,0,0,70,531,439,92,879.8
2022-04-02T22:00,46.1,30,0,0,100,342,263,79,790.8
2022-04-02T23:00,43.9,31,0,1,100,105,27,78,434.4
2022-04-03T00:00,41,50,0,33,100,8,0,8,25.9
2022-04-03T01:00,38.6,74,0,74,100,0,0,0,0
2022-04-03T02:00,37.3,86,0,100,88,0,0,0,0
2022-04-03T03:00,36.4,58,0,91,12,0,0,0,0
2022-04-03T04:00,35.7,63,0,95,21,0,0,0,0
2022-04-03T05:00,35.5,80,0,97,73,0,0,0,0
2022-04-03T06:00,35.6,87,0,99,91,0,0,0,0
2022-04-03T07:00,36.7,86,0,100,86,0,0,0,0
2022-04-03T08:00,37.3,92,5,100,92,0,0,0,0
2022-04-03T09:00,37.5,78,3,100,52,0,0,0,0
2022-04-03T10:00,37.5,77,2,100,51,0,0,0,0
2022-04-03T11:00,37.1,91,11,98,73,0,0,0,0
2022-04-03T12:00,37,100,23,100,98,23,1,22,3.6
2022-04-03T13:00,37.1,100,31,99,91,54,0,54,4.5
2022-04-03T14:00,37.6,100,33,100,51,98,0,98,0
2022-04-03T15:00,38,100,54,97,9,165,15,150,11.2
2022-04-03T16:00,40.4,100,100,97,5,200,27,173,33
2022-04-03T17:00,39.1,100,100,100,14,143,0,143,19.3
2022-04-03T18:00,37.1,100,100,100,42,140,2,138,0.1
2022-04-03T19:00,38.7,100,92,98,62,285,49,236,30.6
2022-04-03T20:00,39.3,100,85,100,81,326,88,238,100.1
2022-04-03T21:00,39.5,100,87,100,83,291,81,210,148.4
2022-04-03T22:00,38.7,100,58,100,83,156,26,130,113.9
2022-04-03T23:00,37.4,100,45,99,90,54,6,48,48.9
2022-04-04T00:00,36.6,100,37,98,96,5,0,5,7
2022-04-04T01:00,36.3,100,23,95,80,0,0,0,0
2022-04-04T02:00,36.2,100,45,79,50,0,0,0,0
2022-04-04T03:00,36,100,64,64,54,0,0,0,0
2022-04-04T04:00,35.7,100,74,55,50,0,0,0,0
2022-04-04T05:00,35.3,92,75,34,15,0,0,0,0
2022-04-04T06:00,34.9,70,78,0,0,0,0,0,0
2022-04-04T07:00,35.7,79,88,0,0,0,0,0,0
2022-04-04T08:00,35.6,68,76,0,0,0,0,0,0
2022-04-04T09:00,35.4,66,73,0,0,0,0,0,0
2022-04-04T10:00,35.1,74,82,0,0,0,0,0,0
2022-04-04T11:00,34.8,73,81,0,0,1,0,1,0
2022-04-04T12:00,35.4,52,58,0,0,50,17,33,56.7
2022-04-04T13:00,36.9,66,73,0,0,170,76,94,186.3
2022-04-04T14:00,39.4,100,88,0,99,288,102,186,229.8
2022-04-04T15:00,40.8,100,91,0,98,336,84,252,167
2022-04-04T16:00,43.2,100,98,37,94,466,146,320,163.9
2022-04-04T17:00,45,100,100,84,99,464,130,334,186.2
2022-04-04T18:00,46.8,100,95,99,98,423,105,318,151.6
2022-04-04T19:00,45.8,100,88,97,63,319,15,304,72.6
2022-04-04T20:00,46.8,100,94,89,3,336,56,280,45.4
2022-04-04T21:00,46.4,100,85,91,95,266,63,203,103
2022-04-04T22:00,45.9,100,23,95,90,184,44,140,119.2
2022-04-04T23:00,44.2,45,0,37,76,99,20,79,113.6
2022-04-05T00:00,42.2,41,0,40,55,10,1,9,27.4
2022-04-05T01:00,40.7,28,0,37,18,0,0,0,0
2022-04-05T02:00,38.9,4,0,6,0,0,0,0,0
2022-04-05T03:00,36.7,26,0,44,0,0,0,0,0
2022-04-05T04:00,35.9,51,0,85,0,0,0,0,0
2022-04-05T05:00,35.7,61,4,96,0,0,0,0,0
2022-04-05T06:00,35.7,69,13,96,0,0,0,0,0
2022-04-05T07:00,36.9,74,18,97,0,0,0,0,0
2022-04-05T08:00,37.1,42,1,69,0,0,0,0,0
2022-04-05T09:00,36.9,26,16,20,0,0,0,0,0
2022-04-05T10:00,36.3,70,35,36,56,0,0,0,0
2022-04-05T11:00,36.8,77,48,41,30,1,0,1,0
2022-04-05T12:00,38.8,86,19,66,99,62,27,35,86.5
2022-04-05T13:00,43.1,61,7,74,33,204,118,86,278.2
2022-04-05T14:00,48.4,34,2,53,0,375,235,140,414.5
2022-04-05T15:00,53.1,13,1,20,0,574,439,135,582.6
2022-04-05T16:00,56.7,3,0,5,0,705,553,152,722.2
2022-04-05T17:00,59.7,1,0,1,0,832,714,118,823.3
2022-04-05T18:00,62.2,3,0,5,0,860,764,96,933.9
2022-04-05T19:00,63.6,7,0,9,4,790,686,104,942.9
2022-04-05T20:00,64,47,0,63,32,592,416,176,775.8
2022-04-05T21:00,62.2,78,0,82,96,310,162,148,452.7
2022-04-05T22:00,60.2,72,0,70,100,218,98,120,271.5
2022-04-05T23:00,56.8,69,1,64,100,95,24,71,194.4
2022-04-06T00:00,52.7,32,1,1,100,12,0,12,30.7
2022-04-06T01:00,50.8,31,0,2,100,0,0,0,0
2022-04-06T02:00,49.8,43,3,17,100,0,0,0,0
2022-04-06T03:00,48.9,48,5,22,100,0,0,0,0
2022-04-06T04:00,47.6,64,0,57,100,0,0,0,0
2022-04-06T05:00,46.2,79,0,81,100,0,0,0,0
2022-04-06T06:00,45.3,86,0,94,100,0,0,0,0
2022-04-06T07:00,46.3,86,1,92,100,0,0,0,0
2022-04-06T08:00,45.7,90,1,99,100,0,0,0,0
2022-04-06T09:00,45,90,4,94,100,0,0,0,0
2022-04-06T10:00,44.6,89,1,97,100,0,0,0,0
2022-04-06T11:00,44.3,89,5,90,100,1,0,1,0
2022-04-06T12:00,45.1,52,20,7,100,46,2,44,2.5
2022-04-06T13:00,47.6,71,38,12,100,167,35,132,48.3
2022-04-06T14:00,51.3,77,53,7,84,378,186,192,235.8
2022-04-06T15:00,54.9,86,79,24,1,502,304,198,436.8
2022-04-06T16:00,57.3,73,74,11,0,464,287,177,431.2
2022-04-06T17:00,59.9,91,100,2,0,627,396,231,439.7
2022-04-06T18:00,61.3,100,100,1,93,563,345,218,479.4
2022-04-06T19:00,63.4,100,100,12,85,408,106,302,288.8
2022-04-06T20:00,62.8,100,99,44,33,251,5,246,59.1
2022-04-06T21:00,61.6,100,98,54,71,205,45,160,42.4
2022-04-06T22:00,59.1,100,100,80,90,76,0,76,45.2
2022-04-06T23:00,56.7,100,100,65,91,34,0,34,0
2022-04-07T00:00,54.6,13,3,11,11,5,0,5,0
2022-04-07T01:00,52.2,16,2,5,36,0,0,0,0
2022-04-07T02:00,50.7,100,36,76,98,0,0,0,0
2022-04-07T03:00,49.5,100,63,93,100,0,0,0,0
2022-04-07T04:00,48.1,100,92,92,100,0,0,0,0
2022-04-07T05:00,47.4,100,83,99,99,0,0,0,0
2022-04-07T06:00,46.9,100,96,100,50,0,0,0,0
2022-04-07T07:00,47.5,100,96,100,68,0,0,0,0
2022-04-07T08:00,47.4,100,72,95,95,0,0,0,0
2022-04-07T09:00,47.3,100,100,100,73,0,0,0,0
2022-04-07T10:00,47.2,100,100,100,47,0,0,0,0
2022-04-07T11:00,47,100,100,99,31,0,0,0,0
2022-04-07T12:00,46.8,100,100,100,24,7,0,7,0
2022-04-07T13:00,46.9,100,100,100,24,19,0,19,0
2022-04-07T14:00,46.7,100,100,100,15,45,0,45,0
2022-04-07T15:00,46.8,100,100,100,11,65,0,65,0
2022-04-07T16:00,46.6,100,100,100,33,60,0,60,0
2022-04-07T17:00,46.6,100,100,98,57,73,0,73,0
2022-04-07T18:00,46.6,100,100,97,39,78,0,78,0
2022-04-07T19:00,46.9,100,100,96,24,73,0,73,0
2022-04-07T20:00,47,100,100,87,27,48,0,48,0
2022-04-07T21:00,47.4,100,55,98,41,65,0,65,0
2022-04-07T22:00,47.3,100,96,95,23,44,0,44,0
2022-04-07T23:00,46.8,100,100,88,23,25,3,22,8.2
2022-04-08T00:00,45.8,100,100,96,28,3,0,3,4.2
2022-04-08T01:00,45.8,100,100,98,32,0,0,0,0
2022-04-08T02:00,45.4,100,100,97,7,0,0,0,0
2022-04-08T03:00,45,100,100,93,0,0,0,0,0
2022-04-08T04:00,44.9,92,89,19,3,0,0,0,0
2022-04-08T05:00,44.8,63,46,35,1,0,0,0,0
2022-04-08T06:00,44.7,40,32,19,0,0,0,0,0
2022-04-08T07:00,43.6,47,50,4,0,0,0,0,0
2022-04-08T08:00,42.3,46,47,6,0,0,0,0,0
2022-04-08T09:00,41.6,28,22,13,0,0,0,0,0
2022-04-08T10:00,40.9,60,34,49,0,0,0,0,0
2022-04-08T11:00,40.4,97,60,71,0,3,1,2,0
2022-04-08T12:00,41.5,77,50,53,0,59,21,38,82.6
2022-04-08T13:00,44.1,26,15,20,0,192,103,89,210.5
2022-04-08T14:00,47.2,1,1,0,0,377,270,107,412.5
2022-04-08T15:00,50.3,20,9,19,0,582,465,117,631
2022-04-08T16:00,52.4,38,6,54,0,675,527,148,726.6
2022-04-08T17:00,53.6,31,0,52,0,631,381,250,588.7
2022-04-08T18:00,54,31,0,52,0,626,387,239,462
2022-04-08T19:00,55.8,41,0,66,5,637,419,218,505
2022-04-08T20:00,56.4,58,0,64,65,616,448,168,606.8
2022-04-08T21:00,56.3,64,0,70,74,466,313,153,627.9
2022-04-08T22:00,54.9,86,0,100,88,260,138,122,474
2022-04-08T23:00,49.7,88,2,98,91,72,1,71,173.8
2022-04-09T00:00,47.7,93,7,97,94,7,0,7,0.1
2022-04-09T01:00,46.5,86,3,93,93,0,0,0,0
2022-04-09T02:00,45,79,4,84,83,0,0,0,0
2022-04-09T03:00,43.2,90,11,86,95,0,0,0,0
2022-04-09T04:00,41.6,99,11,100,97,0,0,0,0
2022-04-09T05:00,40.6,100,18,98,98,0,0,0,0
2022-04-09T06:00,40,97,11,98,95,0,0,0,0
2022-04-09T07:00,41.4,89,0,99,97,0,0,0,0
2022-04-09T08:00,40.7,85,0,99,86,0,0,0,0
2022-04-09T09:00,39.3,80,0,99,69,0,0,0,0
2022-04-09T10:00,38,80,0,100,68,0,0,0,0
2022-04-09T11:00,37.5,87,0,100,89,4,0,4,0
2022-04-09T12:00,40.6,99,14,100,89,76,15,61,40.6
2022-04-09T13:00,44,100,16,100,95,210,71,139,147.5
2022-04-09T14:00,45.8,97,12,97,92,362,158,204,260.9
2022-04-09T15:00,47.4,100,22,94,92,451,179,272,290.8
2022-04-09T16:00,49.4,86,17,74,87,600,282,318,319.9
2022-04-09T17:00,51.3,89,51,50,44,644,331,313,395.7
2022-04-09T18:00,51.9,95,83,25,19,588,321,267,406.5
2022-04-09T19:00,52.4,75,60,28,14,526,230,296,338.4
2022-04-09T20:00,51.7,60,12,71,23,535,320,215,379.4
2022-04-09T21:00,47.1,81,44,68,3,408,232,176,456.9
2022-04-09T22:00,46.3,44,5,64,5,238,108,130,345.4
2022-04-09T23:00,45.5,36,7,47,5,127,62,65,284.2
2022-04-10T00:00,43.9,29,13,19,20,19,8,11,105.8
2022-04-10T01:00,42,21,7,16,17,0,0,0,0
2022-04-10T02:00,40.5,30,29,7,0,0,0,0,0
2022-04-10T03:00,39.1,34,36,3,1,0,0,0,0
2022-04-10T04:00,37.8,49,51,1,7,0,0,0,0
2022-04-10T05:00,36.9,65,67,6,2,0,0,0,0
2022-04-10T06:00,36.7,72,75,7,0,0,0,0,0
2022-04-10T07:00,36.7,74,78,7,0,0,0,0,0
2022-04-10T08:00,36.2,71,77,3,0,0,0,0,0
2022-04-10T09:00,36,84,84,8,11,0,0,0,0
2022-04-10T10:00,35.2,64,25,52,34,0,0,0,0
2022-04-10T11:00,35.1,70,13,86,21,4,0,4,0
2022-04-10T12:00,35.6,86,33,94,1,60,12,48,34.1
2022-04-10T13:00,36.7,85,31,95,0,148,33,115,82.8
2022-04-10T14:00,38.8,62,17,78,0,305,85,220,122
2022-04-10T15:00,40.4,73,39,63,0,469,219,250,248.9
2022-04-10T16:00,41.4,50,22,51,0,546,266,280,347.4
2022-04-10T17:00,42.1,66,35,58,0,654,308,346,363.8
2022-04-10T18:00,42.6,100,75,61,0,599,335,264,392.7
2022-04-10T19:00,44.3,100,91,93,0,571,350,221,437.5
2022-04-10T20:00,44.1,100,77,76,0,461,194,267,367.2
2022-04-10T21:00,43.6,82,45,69,0,389,189,200,306.6
2022-04-10T22:00,42.9,100,80,87,0,247,103,144,309.4
2022-04-10T23:00,41.4,100,76,67,0,99,22,77,180.2
2022-04-11T00:00,39.9,67,49,38,0,16,4,12,36.5
2022-04-11T01:00,38.3,33,34,4,0,0,0,0,0
2022-04-11T02:00,37.7,15,17,0,0,0,0,0,0
2022-04-11T03:00,36.9,29,31,1,0,0,0,0,0
2022-04-11T04:00,35.9,18,20,0,0,0,0,0,0
2022-04-11T05:00,35.1,18,20,0,0,0,0,0,0
2022-04-11T06:00,34.5,4,4,0,0,0,0,0,0
2022-04-11T07:00,33.5,1,1,0,0,0,0,0,0
2022-04-11T08:00,32.4,1,0,0,3,0,0,0,0
2022-04-11T09:00,32.4,1,1,0,0,0,0,0,0
2022-04-11T10:00,34.5,1,1,0,0,0,0,0,0
2022-04-11T11:00,31.3,1,1,0,0,7,3,4,0
2022-04-11T12:00,35.8,14,0,0,45,131,90,41,302.4
2022-04-11T13:00,40.6,30,0,0,99,326,256,70,631.8
2022-04-11T14:00,44.2,29,0,0,95,522,436,86,781.3
2022-04-11T15:00,48.2,29,0,0,98,676,560,116,848.4
2022-04-11T16:00,52.2,29,0,0,96,752,548,204,790.8
2022-04-11T17:00,55.8,32,0,4,98,742,442,300,631.8
2022-04-11T18:00,58.7,31,0,21,61,687,327,360,444.4
2022-04-11T19:00,62.5,17,0,23,11,796,652,144,605.4
2022-04-11T20:00,63.7,12,0,11,17,704,601,103,882.7
2022-04-11T21:00,62.8,44,0,24,100,468,333,135,752.4
2022-04-11T22:00,59.1,75,0,75,100,206,82,124,397.6
2022-04-11T23:00,53.4,64,0,57,100,77,13,64,120
2022-04-12T00:00,50.4,74,14,53,100,7,0,7,17.1
2022-04-12T01:00,49.9,100,53,89,100,0,0,0,0
2022-04-12T02:00,49.3,100,85,98,98,0,0,0,0
2022-04-12T03:00,49.5,100,74,100,100,0,0,0,0
2022-04-12T04:00,49.5,100,91,100,100,0,0,0,0
2022-04-12T05:00,50.1,100,100,100,100,0,0,0,0
2022-04-12T06:00,50.6,100,100,100,93,0,0,0,0
2022-04-12T07:00,49.4,100,100,100,98,0,0,0,0
2022-04-12T08:00,49.5,100,100,100,95,0,0,0,0
2022-04-12T09:00,49.9,100,100,100,98,0,0,0,0
2022-04-12T10:00,50.4,100,74,99,98,0,0,0,0
2022-04-12T11:00,50.4,100,32,100,100,1,0,1,0
2022-04-12T12:00,49.9,22,2,10,46,34,9,25,9.8
2022-04-12T13:00,51.5,23,26,0,0,266,145,121,224.9
2022-04-12T14:00,54.1,33,37,0,0,387,218,169,411
2022-04-12T15:00,57.2,15,17,0,0,589,439,150,527.4
2022-04-12T16:00,59.5,5,5,0,0,765,622,143,740.2
2022-04-12T17:00,61.4,3,3,0,0,851,739,112,859.5
2022-04-12T18:00,63,0,0,0,0,887,780,107,925.3
2022-04-12T19:00,63.3,0,0,0,1,839,732,107,940.9
2022-04-12T20:00,63.2,18,0,0,60,735,645,90,934
2022-04-12T21:00,62.9,23,0,0,75,579,497,82,910.7
2022-04-12T22:00,61.4,27,0,0,89,385,311,74,834.3
2022-04-12T23:00,58.3,29,0,0,96,184,129,55,689.8
2022-04-13T00:00,54.8,8,0,0,25,26,13,13,223.5
2022-04-13T01:00,51.3,8,0,3,22,0,0,0,0
2022-04-13T02:00,49.3,9,0,7,15,0,0,0,0
2022-04-13T03:00,47.4,51,0,41,88,0,0,0,0
2022-04-13T04:00,44.8,11,0,0,35,0,0,0,0
2022-04-13T05:00,44,5,0,4,10,0,0,0,0
2022-04-13T06:00,43.7,5,0,8,0,0,0,0,0
2022-04-13T07:00,44.9,20,0,29,7,0,0,0,0
2022-04-13T08:00,44.6,50,11,67,0,0,0,0,0
2022-04-13T09:00,44.5,77,35,69,14,0,0,0,0
2022-04-13T10:00,46.1,98,49,61,56,0,0,0,0
2022-04-13T11:00,49,100,88,83,59,4,1,3,0
2022-04-13T12:00,51.4,73,34,41,59,30,2,28,16.7
2022-04-13T13:00,54.7,40,12,21,54,109,42,67,50.4
2022-04-13T14:00,62.1,11,2,5,21,299,198,101,252.8
2022-04-13T15:00,64,11,3,10,9,311,129,182,283.1
2022-04-13T16:00,68,38,6,31,45,533,351,182,308.9
2022-04-13T17:00,71.3,55,0,60,63,640,482,158,525.8
2022-04-13T18:00,75.6,58,5,52,73,751,567,184,654.1
2022-04-13T19:00,75.9,58,1,52,86,442,237,205,496.6
2022-04-13T20:00,76,65,3,53,100,518,255,263,322.2
2022-04-13T21:00,75,59,0,49,100,352,142,210,322.4
2022-04-13T22:00,72.5,89,1,96,100,126,1,125,123.6
2022-04-13T23:00,69.8,90,0,100,99,61,1,60,0.8
2022-04-14T00:00,66.8,90,0,100,99,6,0,6,0.7
2022-04-14T01:00,65.3,74,0,85,75,0,0,0,0
2022-04-14T02:00,63.9,48,0,46,67,0,0,0,0
2022-04-14T03:00,62.7,60,0,72,56,0,0,0,0
2022-04-14T04:00,62.2,45,0,60,29,0,0,0,0
2022-04-14T05:00,62,26,0,40,6,0,0,0,0
2022-04-14T06:00,62.1,29,0,43,9,0,0,0,0
2022-04-14T07:00,61.7,37,2,29,60,0,0,0,0
2022-04-14T08:00,60.6,38,0,26,76,0,0,0,0
2022-04-14T09:00,59.9,40,0,39,56,0,0,0,0
2022-04-14T10:00,59.1,22,0,0,73,0,0,0,0
2022-04-14T11:00,59.1,20,1,1,62,8,3,5,0
2022-04-14T12:00,62,17,2,3,45,78,40,38,139.2
2022-04-14T13:00,65.7,24,1,0,76,222,155,67,319.5
2022-04-14T14:00,69.3,32,0,7,93,369,230,139,427.5
2022-04-14T15:00,72.5,81,17,60,100,505,347,158,482.7
2022-04-14T16:00,70.8,100,24,89,100,371,173,198,383.3
2022-04-14T17:00,65.9,100,39,95,100,194,15,179,110.8
2022-04-14T18:00,59.2,100,100,99,100,84,6,78,4.5
2022-04-14T19:00,57.6,100,50,100,70,84,0,84,3.2
2022-04-14T20:00,54,59,4,93,0,78,0,78,0
2022-04-14T21:00,51.5,40,0,66,0,140,47,93,28.7
2022-04-14T22:00,53.1,9,0,15,0,243,150,93,218.1
2022-04-14T23:00,52.9,0,0,0,0,172,125,47,477.6
2022-04-15T00:00,50.8,0,0,0,0,32,19,13,245.4
2022-04-15T01:00,49.3,0,0,0,0,0,0,0,0
2022-04-15T02:00,49,0,0,0,0,0,0,0,0
2022-04-15T03:00,45,0,0,0,0,0,0,0,0
2022-04-15T04:00,44,0,0,0,0,0,0,0,0
2022-04-15T05:00,42.3,0,0,0,0,0,0,0,0
2022-04-15T06:00,42,0,0,0,0,0,0,0,0
2022-04-15T07:00,42.1,0,0,0,0,0,0,0,0
2022-04-15T08:00,41.9,0,0,0,0,0,0,0,0
2022-04-15T09:00,41.9,0,0,0,0,0,0,0,0
2022-04-15T10:00,41.6,0,0,0,0,0,0,0,0
2022-04-15T11:00,41.4,0,0,0,0,13,6,7,0
2022-04-15T12:00,45.2,0,0,0,0,152,108,44,348.2
2022-04-15T13:00,50.4,13,0,22,0,355,289,66,680.6
2022-04-15T14:00,54.5,1,0,2,0,532,434,98,798.2
2022-04-15T15:00,57.2,0,0,0,0,634,467,167,746.9
2022-04-15T16:00,59.6,5,0,6,4,718,529,189,671.5
2022-04-15T17:00,62.3,71,0,92,51,865,716,149,776.2
2022-04-15T18:00,63.6,85,1,93,95,752,563,189,802
2022-04-15T19:00,59.4,50,0,59,50,327,32,295,341.8
2022-04-15T20:00,60.6,66,0,62,96,452,233,219,160.4
2022-04-15T21:00,62.9,87,0,96,99,370,146,224,314.7
2022-04-15T22:00,60.2,84,0,90,99,175,20,155,152.4
2022-04-15T23:00,59,89,0,99,99,63,0,63,16
2022-04-16T00:00,57.7,90,0,100,100,12,0,12,0
2022-04-16T01:00,55.3,54,0,89,2,0,0,0,0
2022-04-16T02:00,53.5,59,0,99,0,0,0,0,0
2022-04-16T03:00,52.8,61,2,92,14,0,0,0,0
2022-04-16T04:00,52.5,66,1,98,22,0,0,0,0
2022-04-16T05:00,51.6,68,0,74,79,0,0,0,0
2022-04-16T06:00,49.9,72,0,71,98,0,0,0,0
2022-04-16T07:00,48.1,86,2,90,99,0,0,0,0
2022-04-16T08:00,47.4,100,16,100,99,0,0,0,0
2022-04-16T09:00,48.1,100,85,100,97,0,0,0,0
2022-04-16T10:00,47.4,100,93,99,99,0,0,0,0
2022-04-16T11:00,46.3,100,100,100,100,3,0,3,0
2022-04-16T12:00,46.8,100,100,99,64,37,2,35,5.1
2022-04-16T13:00,45.8,100,100,99,61,56,2,54,8.1
2022-04-16T14:00,45.6,100,100,99,27,76,0,76,2.4
2022-04-16T15:00,45.2,100,100,99,92,103,0,103,0
2022-04-16T16:00,46.3,100,100,98,99,152,0,152,0
2022-04-16T17:00,47,100,99,100,100,215,4,211,1.2
2022-04-16T18:00,46.2,100,82,87,98,263,25,238,16.9
2022-04-16T19:00,44.5,100,80,55,46,172,31,141,32.3
2022-04-16T20:00,44,83,58,51,0,289,79,210,60.1
2022-04-16T21:00,46.7,83,55,56,0,429,275,154,299.1
2022-04-16T22:00,46.8,44,14,51,2,253,154,99,445.1
2022-04-16T23:00,45.7,54,28,48,0,126,61,65,316.3
2022-04-17T00:00,43.6,77,52,50,0,20,10,10,120.4
2022-04-17T01:00,42.3,100,78,78,0,0,0,0,0
2022-04-17T02:00,39.6,100,97,95,0,0,0,0,0
2022-04-17T03:00,37.2,100,69,96,0,0,0,0,0
2022-04-17T04:00,35.9,55,28,49,0,0,0,0,0
2022-04-17T05:00,35.3,5,3,4,0,0,0,0,0
2022-04-17T06:00,34,11,11,2,0,0,0,0,0
2022-04-17T07:00,33.3,18,20,0,0,0,0,0,0
2022-04-17T08:00,32.6,23,26,0,0,0,0,0,0
2022-04-17T09:00,32.1,24,27,0,0,0,0,0,0
2022-04-17T10:00,31.7,47,43,13,0,0,0,0,0
2022-04-17T11:00,31.7,66,31,63,0,13,5,8,0
2022-04-17T12:00,32.5,91,37,96,0,118,68,50,219.6
2022-04-17T13:00,34.3,100,73,85,0,293,182,111,416.9
2022-04-17T14:00,36.3,98,74,52,0,421,224,197,445.4
2022-04-17T15:00,38.4,50,41,21,0,537,296,241,406.3
2022-04-17T16:00,40.7,52,44,20,0,729,521,208,547.2
2022-04-17T17:00,41.5,44,34,23,0,743,535,208,656.6
2022-04-17T18:00,42.7,45,23,40,0,814,618,196,681.1
2022-04-17T19:00,44,30,14,29,0,811,632,179,766
2022-04-17T20:00,45,17,5,21,0,709,548,161,788.5
2022-04-17T21:00,44.8,0,0,0,0,540,394,146,727.6
2022-04-17T22:00,44.1,0,0,0,0,378,277,101,670.7
2022-04-17T23:00,42.6,0,0,0,0,198,142,56,640.6
2022-04-18T00:00,40,0,0,0,0,37,22,15,286.2
2022-04-18T01:00,38.4,0,0,0,0,0,0,0,0
2022-04-18T02:00,36.9,0,0,0,0,0,0,0,0
2022-04-18T03:00,35.1,0,0,0,0,0,0,0,0
2022-04-18T04:00,34.2,0,0,0,0,0,0,0,0
2022-04-18T05:00,37.5,0,0,0,0,0,0,0,0
2022-04-18T06:00,37.4,0,0,0,0,0,0,0,0
2022-04-18T07:00,36.9,0,0,0,0,0,0,0,0
2022-04-18T08:00,36.4,0,0,0,0,0,0,0,0
2022-04-18T09:00,30.9,0,0,0,0,0,0,0,0
2022-04-18T10:00,31,0,0,0,0,0,0,0,0
2022-04-18T11:00,31.5,0,0,0,0,19,10,9,0
2022-04-18T12:00,37,26,0,0,87,167,120,47,390.2
2022-04-18T13:00,41.8,26,0,0,85,371,302,69,689.8
2022-04-18T14:00,45.4,24,0,0,79,567,484,83,829.9
2022-04-18T15:00,48.4,30,0,0,100,734,642,92,906.2
2022-04-18T16:00,51.2,37,0,11,100,840,707,133,921.3
2022-04-18T17:00,53.2,58,0,46,100,869,635,234,835.9
2022-04-18T18:00,54,85,0,91,100,755,416,339,637
2022-04-18T19:00,51.2,90,0,100,100,393,48,345,270
2022-04-18T20:00,49.5,90,0,100,100,287,15,272,23.7
2022-04-18T21:00,46.3,90,0,100,100,143,0,143,9.1
2022-04-18T22:00,43.7,91,1,100,100,64,0,64,0
2022-04-18T23:00,40.6,100,17,100,100,26,0,26,0
2022-04-19T00:00,38,100,62,100,100,3,0,3,0
2022-04-19T01:00,37.6,100,85,93,96,0,0,0,0
2022-04-19T02:00,37,100,69,98,100,0,0,0,0
2022-04-19T03:00,36.7,100,77,100,83,0,0,0,0
2022-04-19T04:00,36.5,100,99,100,97,0,0,0,0
2022-04-19T05:00,36.3,100,100,100,59,0,0,0,0
2022-04-19T06:00,36.2,100,100,100,3,0,0,0,0
2022-04-19T07:00,36.1,100,100,100,0,0,0,0,0
2022-04-19T08:00,36,100,100,100,4,0,0,0,0
2022-04-19T09:00,36,100,100,100,6,0,0,0,0
2022-04-19T10:00,36,100,100,100,1,0,0,0,0
2022-04-19T11:00,35.7,100,84,100,0,3,0,3,0
2022-04-19T12:00,35.4,91,33,100,4,19,1,18,2.1
2022-04-19T13:00,35.8,100,50,100,5,85,0,85,1.8
2022-04-19T14:00,36.7,100,61,100,7,190,5,185,1.7
2022-04-19T15:00,38.9,89,37,92,2,346,46,300,32.3
2022-04-19T16:00,40.8,71,21,87,0,511,151,360,118.3
2022-04-19T17:00,41.8,86,40,83,0,680,393,287,333.6
2022-04-19T18:00,43,91,83,27,0,704,334,370,443
2022-04-19T19:00,43.6,50,29,40,0,603,279,324,368.2
2022-04-19T20:00,43.3,100,70,76,0,526,233,293,338.6
2022-04-19T21:00,40.8,65,9,95,0,377,132,245,278.5
2022-04-19T22:00,40.4,55,2,88,0,224,68,156,187.7
2022-04-19T23:00,39.3,68,18,86,0,139,49,90,181.7
2022-04-20T00:00,38.5,92,53,73,0,22,7,15,102
2022-04-20T01:00,37.9,100,84,97,0,0,0,0,0
2022-04-20T02:00,37.5,100,87,99,0,0,0,0,0
2022-04-20T03:00,37.5,100,88,94,0,0,0,0,0
2022-04-20T04:00,37.5,100,91,77,0,0,0,0,0
2022-04-20T05:00,37.4,92,77,37,0,0,0,0,0
2022-04-20T06:00,37.1,72,63,25,0,0,0,0,0
2022-04-20T07:00,37.1,57,61,3,0,0,0,0,0
2022-04-20T08:00,36.9,42,45,2,0,0,0,0,0
2022-04-20T09:00,36.7,26,29,0,0,0,0,0,0
2022-04-20T10:00,36.2,9,10,0,0,0,0,0,0
2022-04-20T11:00,36,9,10,0,0,17,8,9,0
2022-04-20T12:00,37.4,5,5,0,0,139,88,51,277
2022-04-20T13:00,38.6,33,37,0,0,312,210,102,481.9
2022-04-20T14:00,40,54,60,0,0,435,250,185,487.8
2022-04-20T15:00,41.9,51,57,0,0,583,380,203,480
2022-04-20T16:00,44.1,37,41,0,0,803,622,181,661.8
2022-04-20T17:00,46.3,52,56,2,0,888,728,160,826.9
2022-04-20T18:00,47.6,15,12,0,15,913,775,138,885.1
2022-04-20T19:00,49.1,24,9,0,53,869,758,111,925.9
2022-04-20T20:00,49.4,48,1,35,88,761,666,95,937.6
2022-04-20T21:00,48.4,26,0,0,85,595,500,95,893.3
2022-04-20T22:00,46.8,21,0,0,70,406,327,79,814.7
2022-04-20T23:00,46.8,30,0,0,99,201,137,64,669.3
2022-04-21T00:00,44.1,6,0,0,19,39,20,19,278.4
2022-04-21T01:00,41.4,23,0,0,76,0,0,0,0
2022-04-21T02:00,39.7,26,0,0,88,0,0,0,0
2022-04-21T03:00,38.7,20,0,0,68,0,0,0,0
2022-04-21T04:00,38.4,17,0,13,32,0,0,0,0
2022-04-21T05:00,38.2,60,0,95,10,0,0,0,0
2022-04-21T06:00,38.7,34,0,44,26,0,0,0,0
2022-04-21T07:00,41.4,23,0,17,41,0,0,0,0
2022-04-21T08:00,41.7,45,0,61,29,0,0,0,0
2022-04-21T09:00,42.4,86,0,94,98,0,0,0,0
2022-04-21T10:00,42.9,87,0,95,100,0,0,0,0
2022-04-21T11:00,43.7,80,0,86,94,18,4,14,0
2022-04-21T12:00,45.9,63,0,93,23,96,26,70,100.5
2022-04-21T13:00,48,76,0,76,100,123,16,107,83.3
2022-04-21T14:00,49.6,89,0,98,100,119,0,119,15.5
2022-04-21T15:00,49.8,90,4,99,90,179,24,155,8.6
2022-04-21T16:00,53.4,100,88,100,9,422,152,270,110.8
2022-04-21T17:00,53.1,100,97,100,14,408,193,215,220.7
2022-04-21T18:00,53.3,100,100,100,0,244,68,176,157.8
2022-04-21T19:00,51.8,100,100,100,0,130,25,105,50.5
2022-04-21T20:00,51.2,100,100,88,0,106,3,103,15.8
2022-04-21T21:00,52.1,100,100,83,0,94,1,93,1.6
2022-04-21T22:00,52.5,88,66,48,0,62,4,58,4.7
2022-04-21T23:00,52.9,74,53,44,0,46,6,40,16.1
2022-04-22T00:00,52.3,44,28,15,32,13,3,10,18.6
2022-04-22T01:00,52.2,11,9,4,3,0,0,0,0
2022-04-22T02:00,51.2,3,2,1,1,0,0,0,0
2022-04-22T03:00,50,12,2,10,13,0,0,0,0
2022-04-22T04:00,49.2,28,6,38,0,0,0,0,0
2022-04-22T05:00,48.7,30,11,33,0,0,0,0,0
2022-04-22T06:00,48.5,22,18,9,0,0,0,0,0
2022-04-22T07:00,48.2,14,11,1,13,0,0,0,0
2022-04-22T08:00,46.1,10,7,0,11,0,0,0,0
2022-04-22T09:00,43.9,5,5,0,1,0,0,0,0
2022-04-22T10:00,42.3,5,5,0,2,0,0,0,0
2022-04-22T11:00,41.3,1,1,0,0,24,13,11,0
2022-04-22T12:00,42.7,2,2,0,0,178,129,49,398.1
2022-04-22T13:00,44.4,2,2,0,0,374,295,79,663.8
2022-04-22T14:00,47.3,12,13,0,0,547,428,119,748.6
2022-04-22T15:00,49.2,33,37,0,0,671,468,203,702.1
2022-04-22T16:00,51.5,13,14,0,1,824,662,162,733.8
2022-04-22T17:00,53.5,10,11,0,0,918,816,102,894.9
2022-04-22T18:00,55,5,6,0,0,932,833,99,969.5
2022-04-22T19:00,56.3,6,6,0,2,866,758,108,952.6
2022-04-22T20:00,56.4,17,1,0,54,759,664,95,925.5
2022-04-22T21:00,55.8,14,0,0,46,602,514,88,896.3
2022-04-22T22:00,54.4,29,0,0,98,411,332,79,822.7
2022-04-22T23:00,52.1,30,0,0,99,210,147,63,685.4
2022-04-23T00:00,48.6,30,0,0,99,41,17,24,293.9
2022-04-23T01:00,46,30,0,0,100,0,0,0,0
2022-04-23T02:00,44.4,30,0,0,100,0,0,0,0
2022-04-23T03:00,43,30,0,0,100,0,0,0,0
2022-04-23T04:00,40.9,30,0,0,99,0,0,0,0
2022-04-23T05:00,40.1,29,0,0,97,0,0,0,0
2022-04-23T06:00,38.6,29,0,0,95,0,0,0,0
2022-04-23T07:00,37.8,60,0,56,87,0,0,0,0
2022-04-23T08:00,37.5,67,0,87,49,0,0,0,0
2022-04-23T09:00,37.6,45,0,75,1,0,0,0,0
2022-04-23T10:00,38.5,51,0,84,1,0,0,0,0
2022-04-23T11:00,40,47,0,78,0,10,2,8,0
2022-04-23T12:00,42.6,74,0,93,60,59,14,45,48.6
2022-04-23T13:00,45.5,55,0,42,100,130,19,111,54.3
2022-04-23T14:00,48.5,68,0,64,100,178,32,146,49.2
2022-04-23T15:00,50.8,68,0,65,98,223,59,164,64.7
2022-04-23T16:00,54.5,40,0,16,100,356,163,193,134.9
2022-04-23T17:00,58.8,49,0,31,100,540,340,200,306.4
2022-04-23T18:00,60.7,74,0,83,82,464,267,197,366.7
2022-04-23T19:00,63.5,80,3,99,58,354,162,192,259.6
2022-04-23T20:00,59.8,72,22,85,4,181,4,177,83.1
2022-04-23T21:00,62.6,92,48,81,0,350,230,120,184.2
2022-04-23T22:00,62.3,59,17,73,0,267,171,96,408.4
2022-04-23T23:00,60.1,65,14,86,1,139,79,60,351.2
2022-04-24T00:00,56.7,34,14,36,0,38,22,16,195.5
2022-04-24T01:00,54.2,29,15,25,0,0,0,0,0
2022-04-24T02:00,52.6,22,12,19,0,0,0,0,0
2022-04-24T03:00,51.3,14,5,15,0,0,0,0,0
2022-04-24T04:00,50.4,8,2,11,0,0,0,0,0
2022-04-24T05:00,49.6,0,0,0,0,0,0,0,0
2022-04-24T06:00,49.7,0,0,0,0,0,0,0,0
2022-04-24T07:00,49.8,3,0,0,11,0,0,0,0
2022-04-24T08:00,49.5,16,0,3,47,0,0,0,0
2022-04-24T09:00,49.1,2,0,3,1,0,0,0,0
2022-04-24T10:00,48.6,1,0,0,3,0,0,0,0
2022-04-24T11:00,49.3,5,0,1,14,27,13,14,0
2022-04-24T12:00,53.1,27,0,22,46,170,117,53,360.9
2022-04-24T13:00,57.7,39,0,38,53,306,193,113,495.8
2022-04-24T14:00,62.7,12,0,13,15,460,292,168,475.4
2022-04-24T15:00,67.6,11,0,0,37,662,508,154,604.6
2022-04-24T16:00,72.2,22,0,0,72,795,666,129,772.2
2022-04-24T17:00,75.9,5,0,0,15,881,786,95,872.2
2022-04-24T18:00,78.5,28,0,13,67,887,788,99,920.4
2022-04-24T19:00,80,43,0,26,91,787,668,119,867.4
2022-04-24T20:00,80.1,51,0,42,87,680,543,137,786
2022-04-24T21:00,78.1,54,0,46,89,464,316,148,639.1
2022-04-24T22:00,75.2,54,0,46,88,289,192,97,473.6
2022-04-24T23:00,72.5,37,0,23,78,171,118,53,450.8
2022-04-25T00:00,69,34,0,12,90,37,19,18,260.2
2022-04-25T01:00,66.9,31,0,2,98,0,0,0,0
2022-04-25T02:00,65,32,0,5,96,0,0,0,0
2022-04-25T03:00,63.5,30,0,3,94,0,0,0,0
2022-04-25T04:00,61.6,30,0,2,95,0,0,0,0
2022-04-25T05:00,60.1,29,0,1,96,0,0,0,0
2022-04-25T06:00,58.7,30,0,1,97,0,0,0,0
2022-04-25T07:00,57.3,29,0,1,96,0,0,0,0
2022-04-25T08:00,56.4,36,0,15,89,0,0,0,0
2022-04-25T09:00,55.3,34,0,10,93,0,0,0,0
2022-04-25T10:00,54.5,33,0,6,99,0,0,0,0
2022-04-25T11:00,54.1,31,0,4,95,25,8,17,0
2022-04-25T12:00,54.9,44,0,25,97,112,25,87,105.7
2022-04-25T13:00,58.2,44,1,25,94,307,170,137,244
2022-04-25T14:00,62.3,32,0,7,93,495,359,136,518.2
2022-04-25T15:00,66.1,26,0,1,84,658,526,132,681
2022-04-25T16:00,70.1,13,0,0,43,788,656,132,777.4
2022-04-25T17:00,73.2,21,0,3,64,818,661,157,791.8
2022-04-25T18:00,75,31,0,16,70,777,627,150,741.7
2022-04-25T19:00,75.5,40,2,26,76,746,622,124,744.5
2022-04-25T20:00,75.1,39,3,29,63,564,443,121,692
2022-04-25T21:00,73.1,38,1,27,68,357,250,107,506.7
2022-04-25T22:00,70.9,35,0,24,67,253,176,77,398.2
2022-04-25T23:00,68,51,1,38,92,171,111,60,418.7
2022-04-26T00:00,64.5,79,14,63,94,32,16,16,241.8
2022-04-26T01:00,61.8,100,48,83,86,0,0,0,0
2022-04-26T02:00,59.8,100,50,85,88,0,0,0,0
2022-04-26T03:00,58.3,100,32,87,81,0,0,0,0
2022-04-26T04:00,57.2,100,49,93,72,0,0,0,0
2022-04-26T05:00,56.3,100,93,100,44,0,0,0,0
2022-04-26T06:00,55.4,100,99,100,12,0,0,0,0
2022-04-26T07:00,54.2,100,100,100,66,0,0,0,0
2022-04-26T08:00,54.3,100,100,98,71,0,0,0,0
2022-04-26T09:00,54.3,100,100,72,39,0,0,0,0
2022-04-26T10:00,54.3,100,100,68,11,0,0,0,0
2022-04-26T11:00,54.5,100,100,94,45,8,2,6,0
2022-04-26T12:00,55.4,100,100,84,29,39,8,31,32.3
2022-04-26T13:00,54.2,100,100,81,20,100,15,85,31.2
2022-04-26T14:00,54.9,100,100,95,59,176,66,110,76.1
2022-04-26T15:00,54.7,100,100,92,87,208,40,168,90.2
2022-04-26T16:00,54.7,100,100,100,98,141,0,141,25.9
2022-04-26T17:00,55,100,100,100,100,142,0,142,0
2022-04-26T18:00,56,100,100,100,100,214,1,213,0.6
2022-04-26T19:00,54.7,100,100,100,100,145,0,145,0.6
2022-04-26T20:00,54.5,100,100,100,100,147,0,147,0
2022-04-26T21:00,53.7,100,100,100,100,128,3,125,1.9
2022-04-26T22:00,52.6,100,100,71,100,115,7,108,10.4
2022-04-26T23:00,51.2,100,97,44,100,67,5,62,18
2022-04-27T00:00,49.5,100,94,49,100,18,1,17,11.6
2022-04-27T01:00,49,100,80,72,88,0,0,0,0
2022-04-27T02:00,48,96,61,67,4,0,0,0,0
2022-04-27T03:00,46.9,95,63,64,0,0,0,0,0
2022-04-27T04:00,45.9,81,55,52,0,0,0,0,0
2022-04-27T05:00,44.7,100,77,67,0,0,0,0,0
2022-04-27T06:00,43.6,100,98,97,0,0,0,0,0
2022-04-27T07:00,43,100,96,98,0,0,0,0,0
2022-04-27T08:00,42.1,100,95,73,0,0,0,0,0
2022-04-27T09:00,40.5,100,82,53,0,0,0,0,0
2022-04-27T10:00,38.7,59,30,53,0,0,0,0,0
2022-04-27T11:00,37.2,87,57,60,0,17,4,13,0
2022-04-27T12:00,37.2,100,73,67,0,91,9,82,41.6
2022-04-27T13:00,37.9,100,82,94,0,258,92,166,112.1
2022-04-27T14:00,40,100,80,93,0,491,299,192,364.5
2022-04-27T15:00,41.7,95,56,74,0,636,416,220,551.5
2022-04-27T16:00,42.7,60,37,44,0,739,517,222,608.5
2022-04-27T17:00,43.7,54,26,51,0,756,508,248,612.8
2022-04-27T18:00,44.7,100,83,82,0,753,475,278,554.5
2022-04-27T19:00,45,100,70,80,0,795,619,176,662.8
2022-04-27T20:00,43.4,100,82,79,0,511,206,305,523.9
2022-04-27T21:00,42.5,100,79,77,0,435,208,227,295.5
2022-04-27T22:00,41.5,100,97,90,0,274,107,167,294.6
2022-04-27T23:00,40,100,76,74,0,128,63,65,233.8
2022-04-28T00:00,38.8,72,37,64,0,41,17,24,161.1
2022-04-28T01:00,37.8,76,40,67,0,0,0,0,0
2022-04-28T02:00,36.6,100,56,67,38,0,0,0,0
2022-04-28T03:00,35.6,89,61,49,14,0,0,0,0
2022-04-28T04:00,35.1,100,61,76,32,0,0,0,0
2022-04-28T05:00,34.7,100,49,76,64,0,0,0,0
2022-04-28T06:00,34.5,100,61,77,50,0,0,0,0
2022-04-28T07:00,34.4,91,56,66,2,0,0,0,0
2022-04-28T08:00,34.3,30,21,18,0,0,0,0,0
2022-04-28T09:00,34,7,6,2,0,0,0,0,0
2022-04-28T10:00,33.6,5,6,0,0,0,0,0,0
2022-04-28T11:00,33.7,2,2,0,0,40,23,17,0
2022-04-28T12:00,35,0,0,0,0,206,152,54,469.1
2022-04-28T13:00,36.9,11,12,0,0,402,314,88,679
2022-04-28T14:00,38.9,10,11,0,0,589,480,109,772.5
2022-04-28T15:00,41.3,5,5,0,0,764,651,113,857.4
2022-04-28T16:00,43.3,0,0,0,0,865,732,133,894.4
2022-04-28T17:00,45.4,0,0,0,0,964,862,102,939.2
2022-04-28T18:00,46.8,0,0,0,0,970,867,103,994.4
2022-04-28T19:00,47.4,0,0,0,0,915,815,100,988.1
2022-04-28T20:00,47.2,0,0,0,0,804,710,94,973.4
2022-04-28T21:00,46.7,0,0,0,0,645,559,86,941.8
2022-04-28T22:00,45.8,0,0,0,0,452,377,75,882.2
2022-04-28T23:00,44.3,0,0,0,0,246,189,57,774.1
2022-04-29T00:00,42,0,0,0,0,63,41,22,448.6
2022-04-29T01:00,40.1,0,0,0,0,0,0,0,0
2022-04-29T02:00,38.9,0,0,0,0,0,0,0,0
2022-04-29T03:00,37.9,0,0,0,0,0,0,0,0
2022-04-29T04:00,37.1,0,0,0,0,0,0,0,0
2022-04-29T05:00,36.2,0,0,0,0,0,0,0,0
2022-04-29T06:00,35.5,0,0,0,0,0,0,0,0
2022-04-29T07:00,35.5,0,0,0,0,0,0,0,0
2022-04-29T08:00,34.9,0,0,0,0,0,0,0,0
2022-04-29T09:00,34.4,0,0,0,0,0,0,0,0
2022-04-29T10:00,34.1,0,0,0,0,0,0,0,0
2022-04-29T11:00,34.8,0,0,0,0,44,27,17,0
2022-04-29T12:00,37.6,0,0,0,0,216,162,54,506.5
2022-04-29T13:00,40.6,0,0,0,0,420,347,73,727.5
2022-04-29T14:00,43.2,0,0,0,0,615,531,84,851.2
2022-04-29T15:00,45.6,0,0,0,0,779,686,93,919.5
2022-04-29T16:00,47.7,0,0,0,1,898,799,99,957.4
2022-04-29T17:00,49.5,0,0,0,0,963,858,105,976.6
2022-04-29T18:00,50.9,0,0,0,0,968,865,103,984.3
2022-04-29T19:00,52.3,0,0,0,0,914,815,99,984.3
2022-04-29T20:00,52.2,0,0,0,0,801,707,94,968.4
2022-04-29T21:00,51.5,0,0,0,0,642,556,86,933.4
2022-04-29T22:00,50.3,0,0,0,0,450,376,74,874.2
2022-04-29T23:00,48.5,0,0,0,0,246,189,57,766.9
2022-04-30T00:00,45.6,0,0,0,0,64,41,23,449.8
2022-04-30T01:00,43.7,0,0,0,0,0,0,0,0
2022-04-30T02:00,42.3,0,0,0,0,0,0,0,0
2022-04-30T03:00,41.4,0,0,0,0,0,0,0,0
2022-04-30T04:00,40.5,0,0,0,0,0,0,0,0
2022-04-30T05:00,39.8,0,0,0,0,0,0,0,0
2022-04-30T06:00,38.9,0,0,0,0,0,0,0,0
2022-04-30T07:00,37.7,0,0,0,0,0,0,0,0
2022-04-30T08:00,36.3,0,0,0,0,0,0,0,0
2022-04-30T09:00,35.2,0,0,0,0,0,0,0,0
2022-04-30T10:00,35.2,0,0,0,0,0,0,0,0
2022-04-30T11:00,36,0,0,0,0,47,29,18,0
2022-04-30T12:00,42.2,0,0,0,0,220,166,54,518.4
2022-04-30T13:00,46.6,0,0,0,0,424,351,73,731.4
2022-04-30T14:00,50.1,0,0,0,0,618,533,85,851.5
2022-04-30T15:00,52.3,0,0,0,0,781,687,94,917
2022-04-30T16:00,54.1,0,0,0,0,900,800,100,954.8
2022-04-30T17:00,55.8,1,0,0,4,964,863,101,976.9
2022-04-30T18:00,57,1,0,0,4,970,868,102,986.3
2022-04-30T19:00,57.7,4,0,0,14,916,817,99,984.1
2022-04-30T20:00,57.6,14,0,0,48,805,712,93,970.3
2022-04-30T21:00,56.5,21,0,0,69,646,556,90,934.1
2022-04-30T22:00,54.8,27,0,0,89,453,371,82,869.5
2022-04-30T23:00,52,29,0,0,96,232,150,82,688.2
2022-05-01T00:00,48.6,30,0,0,100,57,23,34,320.8
2022-05-01T01:00,45.8,30,0,0,100,0,0,0,0
2022-05-01T02:00,43.6,30,0,0,100,0,0,0,0
2022-05-01T03:00,41.6,28,0,0,92,0,0,0,0
2022-05-01T04:00,41.3,27,0,0,90,0,0,0,0
2022-05-01T05:00,40.5,27,0,0,91,0,0,0,0
2022-05-01T06:00,39.1,24,0,0,79,0,0,0,0
2022-05-01T07:00,37.3,20,0,0,66,0,0,0,0
2022-05-01T08:00,36.5,20,0,0,65,0,0,0,0
2022-05-01T09:00,36.2,13,0,0,42,0,0,0,0
2022-05-01T10:00,36,29,0,0,96,0,0,0,0
2022-05-01T11:00,37.3,17,0,0,58,48,28,20,0
2022-05-01T12:00,43.3,27,0,0,91,218,155,63,479.6
2022-05-01T13:00,50.4,28,0,0,92,412,315,97,665.9
2022-05-01T14:00,55.5,28,0,0,93,578,416,162,707.7
2022-05-01T15:00,59.7,29,0,0,97,734,540,194,714.2
2022-05-01T16:00,63,29,0,0,96,817,570,247,712.9
2022-05-01T17:00,65.6,30,0,0,100,887,624,263,700.1
2022-05-01T18:00,67,30,0,0,100,835,548,287,678.1
2022-05-01T19:00,66.8,38,0,13,100,649,299,350,491.1
2022-05-01T20:00,65.8,56,0,44,100,493,210,283,314.1
2022-05-01T21:00,63.1,82,2,84,100,336,98,238,222.7
2022-05-01T22:00,59.7,92,4,97,100,197,21,176,100.1
2022-05-01T23:00,56.7,84,0,91,99,74,0,74,18.6
2022-05-02T00:00,54.4,85,0,93,98,26,0,26,0
2022-05-02T01:00,52.9,72,0,70,100,0,0,0,0
2022-05-02T02:00,52.1,59,1,47,98,0,0,0,0
2022-05-02T03:00,51.3,41,2,25,81,0,0,0,0
2022-05-02T04:00,50.7,50,16,16,87,0,0,0,0
2022-05-02T05:00,50.4,89,59,18,85,0,0,0,0
2022-05-02T06:00,50.6,100,85,34,87,0,0,0,0
2022-05-02T07:00,51.3,100,92,40,48,0,0,0,0
2022-05-02T08:00,51.4,100,86,49,3,0,0,0,0
2022-05-02T09:00,51.3,97,86,33,0,0,0,0,0
2022-05-02T10:00,50.9,98,90,28,0,0,0,0,0
2022-05-02T11:00,51.2,92,90,18,0,10,1,9,0
2022-05-02T12:00,51.9,100,90,51,0,49,8,41,20.2
2022-05-02T13:00,53.4,100,100,57,0,121,26,95,42.2
2022-05-02T14:00,55.1,100,94,55,0,189,77,112,92.3
2022-05-02T15:00,57.2,83,66,40,0,264,118,146,149.8
2022-05-02T16:00,59.2,100,87,72,0,266,65,201,121.6
2022-05-02T17:00,60.7,79,29,88,0,376,61,315,65.1
2022-05-02T18:00,59.9,100,46,97,2,359,175,184,138.3
2022-05-02T19:00,57.4,100,49,92,32,222,41,181,130.8
2022-05-02T20:00,55.8,100,53,52,73,208,22,186,31.9
2022-05-02T21:00,56.7,100,81,29,82,192,34,158,35.5
2022-05-02T22:00,56.7,100,96,50,49,194,87,107,123.3
2022-05-02T23:00,55.9,100,88,75,2,111,43,68,180.5
2022-05-03T00:00,54.3,100,64,94,0,23,5,18,88.2
2022-05-03T01:00,53.8,87,45,77,0,0,0,0,0
2022-05-03T02:00,53.1,95,85,30,0,0,0,0,0
2022-05-03T03:00,52.4,100,91,81,0,0,0,0,0
2022-05-03T04:00,51.9,100,100,78,0,0,0,0,0
2022-05-03T05:00,51.7,100,98,46,0,0,0,0,0
2022-05-03T06:00,51.7,97,96,18,0,0,0,0,0
2022-05-03T07:00,50,89,93,9,0,0,0,0,0
2022-05-03T08:00,50,93,100,5,0,0,0,0,0
2022-05-03T09:00,50.1,79,84,6,0,0,0,0,0
2022-05-03T10:00,49.5,87,93,0,11,0,0,0,0
2022-05-03T11:00,49.2,100,96,0,58,34,14,20,0
2022-05-03T12:00,53.1,91,73,0,85,169,97,72,267.5
2022-05-03T13:00,55.9,74,49,0,100,283,140,143,333.5
2022-05-03T14:00,60.1,86,51,16,100,531,388,143,473
2022-05-03T15:00,63.3,98,74,2,100,638,447,191,645.3
2022-05-03T16:00,66.1,100,91,0,100,572,307,265,493.2
2022-05-03T17:00,67.8,100,85,24,100,542,187,355,281.3
2022-05-03T18:00,69.1,90,21,68,100,558,187,371,203.5
2022-05-03T19:00,70.6,89,2,96,100,588,203,385,234.9
2022-05-03T20:00,69.4,89,0,99,100,273,19,254,137.3
2022-05-03T21:00,66.4,90,0,100,100,96,0,96,4
2022-05-03T22:00,64.6,86,0,94,100,67,0,67,0
2022-05-03T23:00,63.8,72,0,70,100,52,1,51,0.7
2022-05-04T00:00,63,86,0,95,98,25,2,23,8.2
2022-05-04T01:00,61.6,85,0,91,100,0,0,0,0
2022-05-04T02:00,60.5,57,0,45,100,0,0,0,0
2022-05-04T03:00,60,61,0,51,100,0,0,0,0
2022-05-04T04:00,58.5,85,4,85,100,0,0,0,0
2022-05-04T05:00,56.9,90,2,97,100,0,0,0,0
2022-05-04T06:00,55.7,87,33,46,99,0,0,0,0
2022-05-04T07:00,54.6,100,85,15,99,0,0,0,0
2022-05-04T08:00,53.9,100,90,36,100,0,0,0,0
2022-05-04T09:00,53.2,100,98,54,100,0,0,0,0
2022-05-04T10:00,52.6,100,42,82,100,0,0,0,0
2022-05-04T11:00,52.5,100,100,100,93,11,0,11,0
2022-05-04T12:00,53.1,100,100,100,54,48,3,45,5.5
2022-05-04T13:00,53.6,100,100,100,37,74,3,71,7
2022-05-04T14:00,55.8,100,99,98,26,165,38,127,33.9
2022-05-04T15:00,58.3,100,100,70,28,230,44,186,64.4
2022-05-04T16:00,59.3,100,100,57,39,186,20,166,42
2022-05-04T17:00,60.3,100,100,39,46,173,17,156,20.7
2022-05-04T18:00,58.9,100,100,74,7,93,3,90,11.3
2022-05-04T19:00,57.6,100,100,87,0,103,2,101,2.5
2022-05-04T20:00,54.9,100,100,94,0,55,0,55,1.1
2022-05-04T21:00,53.1,100,100,100,0,42,0,42,0
2022-05-04T22:00,52.1,100,100,98,0,32,0,32,0
2022-05-04T23:00,51.5,100,100,64,0,13,0,13,0
2022-05-05T00:00,51.4,100,95,26,0,8,0,8,0
2022-05-05T01:00,51.9,68,74,3,0,0,0,0,0
2022-05-05T02:00,51.6,41,46,0,0,0,0,0,0
2022-05-05T03:00,50.7,28,30,0,4,0,0,0,0
2022-05-05T04:00,49.7,24,27,0,0,0,0,0,0
2022-05-05T05:00,48.7,13,14,0,0,0,0,0,0
2022-05-05T06:00,47.7,15,12,0,13,0,0,0,0
2022-05-05T07:00,48,19,8,0,40,0,0,0,0
2022-05-05T08:00,46.7,20,2,0,61,0,0,0,0
2022-05-05T09:00,45.3,10,0,0,33,0,0,0,0
2022-05-05T10:00,44.6,31,2,0,96,0,0,0,0
2022-05-05T11:00,44.8,29,0,0,96,55,31,24,0
2022-05-05T12:00,47.5,10,11,0,0,214,143,71,425.7
2022-05-05T13:00,50.5,28,3,0,84,408,308,100,603.1
2022-05-05T14:00,53.8,27,0,0,91,596,476,120,729
2022-05-05T15:00,57.1,20,0,0,66,772,672,100,842
2022-05-05T16:00,59.7,18,0,0,59,881,759,122,910.9
2022-05-05T17:00,61.6,30,0,0,99,925,754,171,882.7
2022-05-05T18:00,62.8,30,0,0,100,861,634,227,775.8
2022-05-05T19:00,63.6,30,0,0,100,860,660,200,747.4
2022-05-05T20:00,63.5,30,0,0,100,705,452,253,700.7
2022-05-05T21:00,62.4,30,0,0,100,518,272,246,515
2022-05-05T22:00,60.9,30,0,0,100,358,146,212,376
2022-05-05T23:00,58.3,30,0,0,100,164,27,137,201.8
2022-05-06T00:00,55.6,31,0,1,100,40,2,38,43.7
2022-05-06T01:00,53.4,31,0,2,100,0,0,0,0
2022-05-06T02:00,51.7,40,0,17,100,0,0,0,0
2022-05-06T03:00,50.4,49,0,31,100,0,0,0,0
2022-05-06T04:00,49.4,70,0,66,100,0,0,0,0
2022-05-06T05:00,48.8,81,0,85,100,0,0,0,0
2022-05-06T06:00,48.6,89,0,99,100,0,0,0,0
2022-05-06T07:00,48.6,90,0,100,100,0,0,0,0
2022-05-06T08:00,48.6,91,1,100,100,0,0,0,0
2022-05-06T09:00,48.6,94,4,100,100,0,0,0,0
2022-05-06T10:00,48.3,90,1,98,100,0,0,0,0
2022-05-06T11:00,48.6,93,3,100,100,16,1,15,0
2022-05-06T12:00,50.3,100,32,96,99,70,13,57,29
2022-05-06T13:00,52,100,53,52,100,119,15,104,40.4
2022-05-06T14:00,55.1,85,18,64,100,248,38,210,46.1
2022-05-06T15:00,57.1,100,45,80,100,331,54,277,66.7
2022-05-06T16:00,58.7,100,44,78,100,404,88,316,89.4
2022-05-06T17:00,59.5,91,12,84,100,426,77,349,97.3
2022-05-06T18:00,59.6,100,25,86,100,411,73,338,84.7
2022-05-06T19:00,60.4,100,54,92,100,383,42,341,67.6
2022-05-06T20:00,59.2,100,76,95,100,214,3,211,24.4
2022-05-06T21:00,58.5,100,96,98,100,199,23,176,19.4
2022-05-06T22:00,56.8,100,79,99,100,80,1,79,21
2022-05-06T23:00,56,100,37,95,100,69,0,69,0.1
2022-05-07T00:00,54.8,74,13,53,100,29,1,28,2
2022-05-07T01:00,53.8,34,4,0,100,0,0,0,0
2022-05-07T02:00,52.7,35,5,0,100,0,0,0,0
2022-05-07T03:00,51.7,35,6,0,100,0,0,0,0
2022-05-07T04:00,50.9,33,3,0,100,0,0,0,0
2022-05-07T05:00,50.4,32,1,1,100,0,0,0,0
2022-05-07T06:00,50.4,30,0,0,100,0,0,0,0
2022-05-07T07:00,50.1,31,0,1,100,0,0,0,0
2022-05-07T08:00,49.6,31,0,1,100,0,0,0,0
2022-05-07T09:00,48.6,32,0,3,100,0,0,0,0
2022-05-07T10:00,47.7,37,0,11,100,0,0,0,0
2022-05-07T11:00,47.6,36,0,10,100,30,5,25,0
2022-05-07T12:00,48,32,0,3,100,121,24,97,66.7
2022-05-07T13:00,49.6,30,0,0,100,252,60,192,107.6
2022-05-07T14:00,51.5,30,0,0,100,398,106,292,147.7
2022-05-07T15:00,53.6,29,0,0,98,555,219,336,229.7
2022-05-07T16:00,55,30,0,0,99,648,301,347,325.6
2022-05-07T17:00,55.8,30,0,0,100,723,391,332,398.2
2022-05-07T18:00,56.1,29,0,0,98,709,416,293,458
2022-05-07T19:00,57.6,30,0,0,100,679,322,357,422.9
2022-05-07T20:00,56.7,29,0,0,97,473,301,172,382.1
2022-05-07T21:00,56.7,30,0,0,99,414,277,137,418.3
2022-05-07T22:00,56,29,0,0,98,305,202,103,436.3
2022-05-07T23:00,54.5,23,0,0,77,186,113,73,403.9
2022-05-08T00:00,52.5,11,0,0,37,78,42,36,326.5
2022-05-08T01:00,49.8,1,0,0,4,1,0,1,7
2022-05-08T02:00,47.7,1,0,0,2,0,0,0,0
2022-05-08T03:00,45.7,0,0,0,0,0,0,0,0
2022-05-08T04:00,43.9,0,0,0,0,0,0,0,0
2022-05-08T05:00,42.6,0,0,0,0,0,0,0,0
2022-05-08T06:00,40.7,0,0,0,0,0,0,0,0
2022-05-08T07:00,40.3,0,0,0,0,0,0,0,0
2022-05-08T08:00,39.2,0,0,0,0,0,0,0,0
2022-05-08T09:00,38,0,0,0,0,0,0,0,0
2022-05-08T10:00,37.5,0,0,0,0,0,0,0,0
2022-05-08T11:00,39.3,0,0,0,0,67,43,24,0
2022-05-08T12:00,45.7,0,0,0,0,247,189,58,540.8
2022-05-08T13:00,49.5,0,0,0,0,448,373,75,743.3
2022-05-08T14:00,52.4,0,0,0,0,638,551,87,851.4
2022-05-08T15:00,55.4,0,0,0,0,797,701,96,911.3
2022-05-08T16:00,58.1,0,0,0,0,911,810,101,946
2022-05-08T17:00,60.3,0,0,0,0,972,869,103,965.4
2022-05-08T18:00,62.1,0,0,0,0,973,871,102,971.9
2022-05-08T19:00,63.6,0,0,0,0,916,815,101,965
2022-05-08T20:00,63.9,0,0,0,0,805,710,95,945.7
2022-05-08T21:00,63.6,0,0,0,0,651,563,88,912.5
2022-05-08T22:00,62.7,0,0,0,0,464,388,76,855.9
2022-05-08T23:00,60.3,0,0,0,0,265,205,60,756.5
2022-05-09T00:00,57.1,0,0,0,0,84,54,30,515.3
2022-05-09T01:00,53.8,0,0,0,0,1,0,1,11.1
2022-05-09T02:00,51.3,0,0,0,0,0,0,0,0
2022-05-09T03:00,49.4,0,0,0,0,0,0,0,0
2022-05-09T04:00,47.6,0,0,0,0,0,0,0,0
2022-05-09T05:00,45.9,0,0,0,0,0,0,0,0
2022-05-09T06:00,44.6,0,0,0,0,0,0,0,0
2022-05-09T07:00,43.9,0,0,0,0,0,0,0,0
2022-05-09T08:00,42.4,0,0,0,0,0,0,0,0
2022-05-09T09:00,40.5,0,0,0,0,0,0,0,0
2022-05-09T10:00,41,0,0,0,0,0,0,0,0
2022-05-09T11:00,42.8,0,0,0,0,69,44,25,0
2022-05-09T12:00,49.3,0,0,0,0,248,190,58,536.7
2022-05-09T13:00,55.8,0,0,0,0,448,373,75,738.9
2022-05-09T14:00,59.4,0,0,0,0,637,550,87,846.2
2022-05-09T15:00,62.2,0,0,0,0,794,699,95,906
2022-05-09T16:00,64.8,0,0,0,0,907,806,101,939.6
2022-05-09T17:00,66.8,0,0,0,0,966,864,102,957.7
2022-05-09T18:00,68.4,1,0,0,2,967,865,102,963.4
2022-05-09T19:00,69.7,0,0,0,0,914,813,101,958
2022-05-09T20:00,70.2,0,0,0,0,804,709,95,941.7
2022-05-09T21:00,70.1,0,0,0,0,650,563,87,909
2022-05-09T22:00,69,0,0,0,0,465,388,77,852
2022-05-09T23:00,66.3,0,0,0,0,266,206,60,752.7
2022-05-10T00:00,62.7,5,0,0,17,86,55,31,517.5
2022-05-10T01:00,58.7,26,0,0,85,1,0,1,13.6
2022-05-10T02:00,56,26,0,0,87,0,0,0,0
2022-05-10T03:00,54,10,0,0,34,0,0,0,0
2022-05-10T04:00,52.6,14,0,0,48,0,0,0,0
2022-05-10T05:00,51.1,19,0,0,62,0,0,0,0
2022-05-10T06:00,49.3,22,0,0,73,0,0,0,0
2022-05-10T07:00,50,25,0,0,82,0,0,0,0
2022-05-10T08:00,48.9,28,0,0,93,0,0,0,0
2022-05-10T09:00,47.5,20,0,0,67,0,0,0,0
2022-05-10T10:00,45.7,18,0,0,60,0,0,0,0
2022-05-10T11:00,45.3,7,0,0,24,72,46,26,0
2022-05-10T12:00,51.5,4,0,0,13,253,195,58,545.1
2022-05-10T13:00,56.2,1,0,0,2,450,370,80,738.3
2022-05-10T14:00,59.9,0,0,0,0,640,548,92,835.7
2022-05-10T15:00,63.2,0,0,0,0,798,703,95,904
2022-05-10T16:00,66.3,0,0,0,0,910,809,101,942
2022-05-10T17:00,68.9,4,0,0,14,967,864,103,957.2
2022-05-10T18:00,70.8,1,0,0,4,967,864,103,960.9
2022-05-10T19:00,73.1,0,0,0,1,911,807,104,952.1
2022-05-10T20:00,73.7,0,0,0,0,801,703,98,931.4
2022-05-10T21:00,73.3,0,0,0,0,648,562,86,901.8
2022-05-10T22:00,72,0,0,0,0,463,384,79,843.3
2022-05-10T23:00,69,0,0,0,0,267,207,60,745.2
2022-05-11T00:00,66.4,1,0,0,4,87,56,31,538.9
2022-05-11T01:00,62.3,2,0,0,5,2,0,2,15.9
2022-05-11T02:00,59,2,0,0,7,0,0,0,0
2022-05-11T03:00,56.1,1,0,0,2,0,0,0,0
2022-05-11T04:00,54.2,2,0,0,6,0,0,0,0
2022-05-11T05:00,53,4,0,0,13,0,0,0,0
2022-05-11T06:00,52.2,2,0,0,5,0,0,0,0
2022-05-11T07:00,53,0,0,0,0,0,0,0,0
2022-05-11T08:00,51.8,0,0,0,0,0,0,0,0
2022-05-11T09:00,50.8,1,0,0,2,0,0,0,0
2022-05-11T10:00,49.7,2,0,0,6,0,0,0,0
2022-05-11T11:00,50.4,0,0,0,0,73,46,27,0
2022-05-11T12:00,55.5,0,0,0,0,252,193,59,532.4
2022-05-11T13:00,61.1,0,0,0,0,452,376,76,736.2
2022-05-11T14:00,65.2,0,0,0,0,641,554,87,844.9
2022-05-11T15:00,68.7,0,0,0,0,798,700,98,903.9
2022-05-11T16:00,71.6,0,0,0,0,910,810,100,937.6
2022-05-11T17:00,73.9,0,0,0,0,970,868,102,958.3
2022-05-11T18:00,75.6,2,0,0,7,969,866,103,962.2
2022-05-11T19:00,77.3,2,0,0,7,916,815,101,955.5
2022-05-11T20:00,77.5,0,0,0,0,805,711,94,939.7
2022-05-11T21:00,77.1,0,0,0,0,651,564,87,905.6
2022-05-11T22:00,75.6,0,0,0,0,466,390,76,847.8
2022-05-11T23:00,73,0,0,0,0,269,208,61,748.7
2022-05-12T00:00,69.9,0,0,0,0,89,57,32,540.2
2022-05-12T01:00,65.9,0,0,0,0,2,0,2,19
2022-05-12T02:00,62.1,0,0,0,0,0,0,0,0
2022-05-12T03:00,59.4,0,0,0,0,0,0,0,0
2022-05-12T04:00,57.2,0,0,0,0,0,0,0,0
2022-05-12T05:00,55.3,0,0,0,0,0,0,0,0
2022-05-12T06:00,53.1,0,0,0,0,0,0,0,0
2022-05-12T07:00,52.7,0,0,0,0,0,0,0,0
2022-05-12T08:00,51.4,0,0,0,0,0,0,0,0
2022-05-12T09:00,49.6,0,0,0,0,0,0,0,0
2022-05-12T10:00,48.7,0,0,0,0,1,0,1,0
2022-05-12T11:00,50.4,0,0,0,0,74,46,28,0
2022-05-12T12:00,58.7,4,0,0,14,248,190,58,518.6
2022-05-12T13:00,66.1,13,0,0,42,444,369,75,718.6
2022-05-12T14:00,71.6,11,0,0,36,630,542,88,823.9
2022-05-12T15:00,75.6,19,0,0,64,785,688,97,883.6
2022-05-12T16:00,78.3,8,0,0,26,898,797,101,920.2
2022-05-12T17:00,80.1,1,0,0,3,955,848,107,937.4
2022-05-12T18:00,81.5,6,0,0,21,957,853,104,941.9
2022-05-12T19:00,82.5,6,0,0,21,898,799,99,937.4
2022-05-12T20:00,82.7,14,0,0,48,791,698,93,919.4
2022-05-12T21:00,81.9,25,0,0,83,642,557,85,888.9
2022-05-12T22:00,80.1,15,0,0,50,461,387,74,836.7
2022-05-12T23:00,77,20,0,0,68,262,201,61,729.4
2022-05-13T00:00,73,27,0,0,90,87,55,32,518.8
2022-05-13T01:00,68.6,25,1,1,78,2,0,2,20.9
2022-05-13T02:00,66.6,22,0,0,74,0,0,0,0
2022-05-13T03:00,64.9,26,0,0,85,0,0,0,0
2022-05-13T04:00,63.5,28,0,0,94,0,0,0,0
2022-05-13T05:00,62.4,28,0,0,94,0,0,0,0
2022-05-13T06:00,61.5,24,0,0,80,0,0,0,0
2022-05-13T07:00,62.5,28,0,0,92,0,0,0,0
2022-05-13T08:00,61.7,29,0,0,98,0,0,0,0
2022-05-13T09:00,61,32,2,0,99,0,0,0,0
2022-05-13T10:00,60.3,32,4,0,93,1,0,1,0
2022-05-13T11:00,61.6,26,3,0,79,65,27,38,0
2022-05-13T12:00,64.9,33,12,0,74,202,118,84,307.3
2022-05-13T13:00,67.9,48,27,0,80,375,260,115,473.8
2022-05-13T14:00,70.9,75,59,0,74,565,409,156,596.6
2022-05-13T15:00,74.2,93,82,0,64,744,607,137,725.4
2022-05-13T16:00,76.2,95,100,0,15,803,648,155,783.9
2022-05-13T17:00,78.1,90,100,0,0,843,667,176,750
2022-05-13T18:00,78.8,84,93,0,0,754,579,175,713.9
2022-05-13T19:00,76.7,83,92,0,0,337,16,321,329
2022-05-13T20:00,77,58,64,1,0,357,26,331,3.4
2022-05-13T21:00,77.1,46,48,4,0,457,273,184,227.8
2022-05-13T22:00,76.1,17,1,26,0,303,184,119,415.7
2022-05-13T23:00,74.3,22,1,32,6,197,126,71,390
2022-05-14T00:00,71.2,31,4,35,22,75,46,29,369.1
2022-05-14T01:00,68.9,25,0,19,46,2,0,2,19.4
2022-05-14T02:00,67.7,14,0,2,43,0,0,0,0
2022-05-14T03:00,66.6,15,0,3,44,0,0,0,0
2022-05-14T04:00,65.4,8,0,1,25,0,0,0,0
2022-05-14T05:00,64.4,8,7,2,1,0,0,0,0
2022-05-14T06:00,64.2,46,45,3,12,0,0,0,0
2022-05-14T07:00,64.7,90,80,5,51,0,0,0,0
2022-05-14T08:00,64.8,100,96,0,65,0,0,0,0
2022-05-14T09:00,64.3,100,99,3,64,0,0,0,0
2022-05-14T10:00,64,91,86,3,40,1,0,1,0
2022-05-14T11:00,64.9,80,83,5,7,36,8,28,0
2022-05-14T12:00,66.7,87,74,26,16,141,40,101,95.9
2022-05-14T13:00,68.4,63,43,28,24,257,108,149,181.9
2022-05-14T14:00,70.2,98,70,33,49,338,144,194,226
2022-05-14T15:00,72.9,83,47,22,92,499,260,239,281.1
2022-05-14T16:00,75.2,74,41,11,100,625,318,307,359.8
2022-05-14T17:00,75.4,66,32,12,100,588,335,253,369.5
2022-05-14T18:00,76.4,62,17,27,100,637,376,261,388.5
2022-05-14T19:00,79.4,64,23,22,100,659,418,241,455.7
2022-05-14T20:00,77.8,56,14,23,100,518,277,241,431.3
2022-05-14T21:00,71.5,70,8,54,100,370,136,234,284.6
2022-05-14T22:00,69.9,36,4,4,100,197,50,147,153.4
2022-05-14T23:00,68.9,49,2,29,100,108,12,96,65.2
2022-05-15T00:00,67.6,31,0,1,100,51,8,43,45
2022-05-15T01:00,66,35,1,7,99,2,0,2,4
2022-05-15T02:00,64.8,42,1,19,100,0,0,0,0
2022-05-15T03:00,64,42,0,20,100,0,0,0,0
2022-05-15T04:00,63.8,68,15,43,97,0,0,0,0
2022-05-15T05:00,63.5,58,11,30,100,0,0,0,0
2022-05-15T06:00,63,58,15,24,99,0,0,0,0
2022-05-15T07:00,64.3,49,20,20,62,0,0,0,0
2022-05-15T08:00,63.9,14,10,8,2,0,0,0,0
2022-05-15T09:00,63,7,4,4,4,0,0,0,0
2022-05-15T10:00,62.9,13,5,14,0,1,0,1,0
2022-05-15T11:00,63.9,11,6,6,5,66,36,30,134.3
2022-05-15T12:00,65.9,14,12,5,1,216,155,61,417.4
2022-05-15T13:00,68.2,18,11,14,0,331,210,121,477.9
2022-05-15T14:00,71.7,29,12,27,7,524,380,144,511.3
2022-05-15T15:00,74.2,16,8,10,10,637,491,146,616.7
2022-05-15T16:00,77.3,31,14,15,30,823,711,112,741.5
2022-05-15T17:00,78.5,34,7,30,31,737,593,144,752.9
2022-05-15T18:00,79.3,49,17,47,18,692,521,171,602.6
2022-05-15T19:00,77.5,31,3,19,56,708,572,136,620.2
2022-05-15T20:00,75.5,39,13,32,28,554,378,176,579.7
2022-05-15T21:00,74.7,20,1,11,41,467,313,154,482.9
2022-05-15T22:00,72.6,24,1,7,63,284,174,110,423.8
2022-05-15T23:00,70.9,23,1,15,44,167,72,95,287.9
2022-05-16T00:00,69.2,20,2,13,34,62,23,39,191.2
2022-05-16T01:00,67.3,11,1,6,20,3,0,3,11.9
2022-05-16T02:00,66,3,0,2,5,0,0,0,0
2022-05-16T03:00,64.8,13,0,1,40,0,0,0,0
2022-05-16T04:00,63.8,10,0,0,34,0,0,0,0
2022-05-16T05:00,63,17,0,1,53,0,0,0,0
2022-05-16T06:00,62.3,30,0,0,99,0,0,0,0
2022-05-16T07:00,62.1,21,0,0,70,0,0,0,0
2022-05-16T08:00,61.7,23,0,0,75,0,0,0,0
2022-05-16T09:00,59.8,28,0,4,85,0,0,0,0
2022-05-16T10:00,59.4,28,0,3,88,1,0,1,0
2022-05-16T11:00,61,28,0,5,83,64,23,41,86.2
2022-05-16T12:00,66.6,18,0,4,53,191,87,104,238.5
2022-05-16T13:00,70.5,28,0,3,86,333,180,153,327.2
2022-05-16T14:00,74.2,35,0,9,98,505,327,178,439.6
2022-05-16T15:00,76.4,58,14,27,97,680,506,174,594.7
2022-05-16T16:00,73.8,100,22,86,100,669,461,208,619.3
2022-05-16T17:00,70.2,92,14,99,66,420,154,266,352.8
2022-05-16T18:00,69,78,59,31,21,319,101,218,117.5
2022-05-16T19:00,68.6,88,43,38,87,482,257,225,210.1
2022-05-16T20:00,64.6,100,40,90,69,177,39,138,184.5
2022-05-16T21:00,61.2,86,38,43,85,108,11,97,20.2
2022-05-16T22:00,57.6,100,66,97,44,194,48,146,54.3
2022-05-16T23:00,57.1,100,98,97,47,101,36,65,108.4
2022-05-17T00:00,56.2,88,45,68,23,44,14,30,106.8
2022-05-17T01:00,55.5,38,35,9,5,2,0,2,8
2022-05-17T02:00,54.9,19,19,3,0,0,0,0,0
2022-05-17T03:00,54.2,9,8,1,3,0,0,0,0
2022-05-17T04:00,53.7,2,1,1,2,0,0,0,0
2022-05-17T05:00,53,0,0,0,0,0,0,0,0
2022-05-17T06:00,52.4,1,1,0,0,0,0,0,0
2022-05-17T07:00,52.5,5,1,7,0,0,0,0,0
2022-05-17T08:00,52.2,8,2,11,0,0,0,0,0
2022-05-17T09:00,52.1,22,5,29,0,0,0,0,0
2022-05-17T10:00,52.3,20,0,34,0,1,0,1,0
2022-05-17T11:00,53.4,24,5,32,0,62,32,30,117.7
2022-05-17T12:00,55.5,35,5,50,0,196,119,77,328.7
2022-05-17T13:00,56.7,38,26,24,0,328,196,132,390
2022-05-17T14:00,58.5,31,32,3,0,556,442,114,546.6
2022-05-17T15:00,59.9,59,57,13,0,684,523,161,708
2022-05-17T16:00,60.7,75,53,46,0,628,345,283,540.8
2022-05-17T17:00,61.7,62,40,44,0,660,379,281,400.7
2022-05-17T18:00,61.5,100,85,86,0,605,282,323,365.5
2022-05-17T19:00,61.3,86,52,66,0,541,235,306,283.5
2022-05-17T20:00,60.4,48,23,45,0,545,250,295,288.8
2022-05-17T21:00,60.2,57,27,55,0,433,287,146,384.4
2022-05-17T22:00,59.2,29,1,46,0,313,182,131,408.7
2022-05-17T23:00,58.1,41,14,48,0,192,115,77,366.2
2022-05-18T00:00,56.6,46,20,47,0,60,23,37,258.3
2022-05-18T01:00,55,53,36,35,0,3,1,2,14.2
2022-05-18T02:00,53.9,38,27,22,0,0,0,0,0
2022-05-18T03:00,53,35,23,23,0,0,0,0,0
2022-05-18T04:00,52.4,11,5,10,0,0,0,0,0
2022-05-18T05:00,51.3,2,1,1,0,0,0,0,0
2022-05-18T06:00,50.4,3,2,2,0,0,0,0,0
2022-05-18T07:00,49.6,2,2,1,0,0,0,0,0
2022-05-18T08:00,48.5,0,0,0,0,0,0,0,0
2022-05-18T09:00,47.5,29,0,0,97,0,0,0,0
2022-05-18T10:00,46.7,30,0,0,99,2,0,2,0
2022-05-18T11:00,47.8,4,0,0,14,82,43,39,158.7
2022-05-18T12:00,50.4,4,1,0,9,232,130,102,387.3
2022-05-18T13:00,52.8,18,5,0,46,397,233,164,438.9
2022-05-18T14:00,55.5,29,0,0,98,636,529,107,648.1
2022-05-18T15:00,57.7,30,0,0,99,804,698,106,883.6
2022-05-18T16:00,59.7,19,0,0,64,871,656,215,844.5
2022-05-18T17:00,61.2,33,0,21,69,834,517,317,661.5
2022-05-18T18:00,62.4,85,0,94,96,810,454,356,527.4
2022-05-18T19:00,64.2,86,1,93,98,714,364,350,464.5
2022-05-18T20:00,64.8,88,0,97,100,479,153,326,313.8
2022-05-18T21:00,62.9,90,0,100,100,164,2,162,91.8
2022-05-18T22:00,60.8,86,0,93,100,106,0,106,0.1
2022-05-18T23:00,58.5,88,0,96,100,66,0,66,0
2022-05-19T00:00,57.1,89,0,98,100,24,0,24,0
2022-05-19T01:00,55.6,90,0,100,100,1,0,1,0
2022-05-19T02:00,54.5,91,1,100,100,0,0,0,0
2022-05-19T03:00,53.5,100,30,100,100,0,0,0,0
2022-05-19T04:00,51.8,100,80,100,100,0,0,0,0
2022-05-19T05:00,51.3,100,93,100,90,0,0,0,0
2022-05-19T06:00,51.6,100,92,100,50,0,0,0,0
2022-05-19T07:00,51.9,100,100,96,32,0,0,0,0
2022-05-19T08:00,52.5,100,100,85,17,0,0,0,0
2022-05-19T09:00,52.8,100,98,99,1,0,0,0,0
2022-05-19T10:00,52.6,100,100,100,0,0,0,0,0
2022-05-19T11:00,53,100,99,96,0,8,0,8,0
2022-05-19T12:00,53.5,100,78,55,0,29,1,28,0.1
2022-05-19T13:00,55.5,100,75,58,0,140,49,91,54.2
2022-05-19T14:00,56.7,100,74,58,0,111,18,93,70.1
2022-05-19T15:00,58,100,92,49,0,113,0,113,11.1
2022-05-19T16:00,60,100,100,92,14,175,2,173,0.6
2022-05-19T17:00,61,97,69,46,25,115,0,115,0.4
2022-05-19T18:00,61.8,70,64,17,8,251,83,168,27.6
2022-05-19T19:00,63.9,58,57,11,0,632,434,198,289
2022-05-19T20:00,64.9,54,49,16,0,648,497,151,591.9
2022-05-19T21:00,65,52,52,9,0,440,265,175,520.6
2022-05-19T22:00,64.4,8,8,2,0,401,277,124,469.8
2022-05-19T23:00,63.4,4,4,0,0,236,159,77,530.3
2022-05-20T00:00,60.9,12,9,6,0,94,54,40,425.3
2022-05-20T01:00,58.5,10,7,5,2,5,2,3,40.1
2022-05-20T02:00,56.4,30,1,1,95,0,0,0,0
2022-05-20T03:00,54.4,4,2,2,3,0,0,0,0
2022-05-20T04:00,53.7,2,2,0,0,0,0,0,0
2022-05-20T05:00,53.4,11,9,5,0,0,0,0,0
2022-05-20T06:00,53.9,22,12,16,4,0,0,0,0
2022-05-20T07:00,55.7,28,9,20,27,0,0,0,0
2022-05-20T08:00,55.9,39,13,31,29,0,0,0,0
2022-05-20T09:00,56.3,41,5,21,80,0,0,0,0
2022-05-20T10:00,56.7,47,0,47,61,2,0,2,0
2022-05-20T11:00,59.2,2,0,1,6,69,37,32,122.6
2022-05-20T12:00,64.1,10,0,0,34,245,186,59,436.7
2022-05-20T13:00,69.3,15,0,0,50,441,363,78,681.7
2022-05-20T14:00,73,30,0,1,97,564,440,124,718.7
2022-05-20T15:00,75.7,39,0,17,95,679,527,152,684.9
2022-05-20T16:00,76.7,41,0,21,94,677,446,231,593
2022-05-20T17:00,79.7,33,2,10,83,814,594,220,571.5
2022-05-20T18:00,81.8,47,7,19,96,823,643,180,681
2022-05-20T19:00,80.2,53,8,29,95,739,590,149,698.2
2022-05-20T20:00,78.2,83,10,76,94,546,390,156,594.9
2022-05-20T21:00,73.6,100,46,91,95,337,203,134,405
2022-05-20T22:00,71.6,100,69,27,96,157,57,100,204.4
2022-05-20T23:00,70.5,83,60,1,93,111,38,73,106.4
2022-05-21T00:00,69.7,82,59,2,92,68,16,52,111.1
2022-05-21T01:00,69,37,41,0,0,5,1,4,13
2022-05-21T02:00,68.5,4,4,0,0,0,0,0,0
2022-05-21T03:00,68.1,12,1,0,36,0,0,0,0
2022-05-21T04:00,67.9,20,0,14,40,0,0,0,0
2022-05-21T05:00,67.7,40,0,50,33,0,0,0,0
2022-05-21T06:00,67.7,65,0,80,55,0,0,0,0
2022-05-21T07:00,68.2,57,0,57,75,0,0,0,0
2022-05-21T08:00,68.3,5,0,0,18,0,0,0,0
2022-05-21T09:00,67.9,1,0,0,3,0,0,0,0
2022-05-21T10:00,67.5,0,0,0,0,2,1,1,0
2022-05-21T11:00,69,0,0,0,0,85,52,33,212.6
2022-05-21T12:00,72.7,1,1,0,0,240,179,61,479.6
2022-05-21T13:00,76.4,0,0,0,0,432,354,78,647.2
2022-05-21T14:00,79.5,1,1,0,0,608,518,90,764.9
2022-05-21T15:00,82.4,4,0,0,14,752,653,99,823.8
2022-05-21T16:00,85.1,27,13,5,40,843,724,119,849.4
2022-05-21T17:00,86.8,62,23,27,83,682,544,138,721.6
2022-05-21T18:00,87,54,4,35,97,613,408,205,512.9
2022-05-21T19:00,87.9,44,4,19,97,531,325,206,395.2
2022-05-21T20:00,88.2,36,2,11,92,604,426,178,458.4
2022-05-21T21:00,87.1,37,1,14,92,456,263,193,479.8
2022-05-21T22:00,84.9,47,0,40,77,320,184,136,378.2
2022-05-21T23:00,82.4,35,0,20,75,184,98,86,332.6
2022-05-22T00:00,77.9,38,0,16,94,70,30,40,248.4
2022-05-22T01:00,74.4,56,2,40,100,4,0,4,24.6
2022-05-22T02:00,72.6,64,2,53,100,0,0,0,0
2022-05-22T03:00,70.7,50,0,33,100,0,0,0,0
2022-05-22T04:00,69.7,35,0,9,100,0,0,0,0
2022-05-22T05:00,69,38,5,5,100,0,0,0,0
2022-05-22T06:00,67.7,27,2,5,73,0,0,0,0
2022-05-22T07:00,68.2,19,2,1,56,0,0,0,0
2022-05-22T08:00,67.1,14,1,0,42,0,0,0,0
2022-05-22T09:00,66.6,13,4,3,24,0,0,0,0
2022-05-22T10:00,65.9,18,12,4,16,2,0,2,0
2022-05-22T11:00,68.5,24,11,3,41,76,42,34,143.6
2022-05-22T12:00,72.8,15,0,2,46,224,139,85,387.3
2022-05-22T13:00,75.1,23,0,13,49,332,161,171,385.6
2022-05-22T14:00,77.4,50,5,42,67,471,262,209,347.4
2022-05-22T15:00,80.9,59,35,25,43,716,555,161,561.8
2022-05-22T16:00,82.8,100,95,22,13,754,568,186,702.5
2022-05-22T17:00,83.8,66,35,46,23,686,478,208,584.8
2022-05-22T18:00,85.3,93,41,44,98,663,499,164,533.7
2022-05-22T19:00,74.7,100,74,78,44,510,309,201,458.8
2022-05-22T20:00,71.8,100,85,76,56,361,113,248,245.9
2022-05-22T21:00,66.6,98,43,89,20,146,33,113,90.4
2022-05-22T22:00,62,100,80,97,13,103,6,97,27.1
2022-05-22T23:00,61,96,49,84,6,49,5,44,7.7
2022-05-23T00:00,59.4,40,20,31,11,42,18,24,66.4
2022-05-23T01:00,57.5,20,15,1,20,5,1,4,17.1
2022-05-23T02:00,56,12,13,0,0,0,0,0,0
2022-05-23T03:00,54.9,15,17,0,0,0,0,0,0
2022-05-23T04:00,54.2,29,24,2,20,0,0,0,0
2022-05-23T05:00,53.4,38,23,3,50,0,0,0,0
2022-05-23T06:00,52.4,48,23,8,74,0,0,0,0
2022-05-23T07:00,52,56,26,11,88,0,0,0,0
2022-05-23T08:00,51.4,57,24,12,95,0,0,0,0
2022-05-23T09:00,50.6,63,34,7,94,0,0,0,0
2022-05-23T10:00,50.3,70,43,2,99,3,0,3,0
2022-05-23T11:00,50.6,100,97,1,93,64,23,41,76.7
2022-05-23T12:00,52,100,100,2,82,187,84,103,212
2022-05-23T13:00,54,100,100,3,87,363,217,146,353.3
2022-05-23T14:00,56.3,100,99,2,83,492,294,198,454.3
2022-05-23T15:00,58.5,100,90,1,98,556,329,227,437.1
2022-05-23T16:00,60,89,68,0,94,624,387,237,429.5
2022-05-23T17:00,61.7,99,77,0,100,722,463,259,478.3
2022-05-23T18:00,62.6,100,77,4,100,677,382,295,472.6
2022-05-23T19:00,62.3,100,92,4,100,523,146,377,289.6
2022-05-23T20:00,62.4,100,100,1,100,472,116,356,148.7
2022-05-23T21:00,61.7,82,57,1,100,348,63,285,117
2022-05-23T22:00,61.2,75,50,0,100,315,91,224,139
2022-05-23T23:00,59.6,66,40,0,100,150,19,131,123.4
2022-05-24T00:00,57.6,35,6,0,100,60,3,57,33.7
2022-05-24T01:00,56.2,33,3,0,100,4,0,4,2.2
2022-05-24T02:00,54.8,31,1,0,100,0,0,0,0
2022-05-24T03:00,53.6,32,1,1,100,0,0,0,0
2022-05-24T04:00,52.6,30,0,0,99,0,0,0,0
2022-05-24T05:00,51.9,29,0,0,96,0,0,0,0
2022-05-24T06:00,50.6,29,0,0,98,0,0,0,0
2022-05-24T07:00,49.7,28,1,0,90,0,0,0,0
2022-05-24T08:00,48.5,26,0,0,87,0,0,0,0
2022-05-24T09:00,47.7,5,0,0,17,0,0,0,0
2022-05-24T10:00,47.6,0,0,0,0,3,1,2,0
2022-05-24T11:00,49.8,1,0,0,2,94,59,35,223.8
2022-05-24T12:00,54.8,3,0,0,9,257,191,66,512.4
2022-05-24T13:00,58.8,3,0,0,10,453,369,84,673.4
2022-05-24T14:00,62.2,0,0,0,0,630,527,103,779.2
2022-05-24T15:00,65.3,0,0,0,0,790,695,95,852.5
2022-05-24T16:00,68,5,5,0,0,872,758,114,889.6
2022-05-24T17:00,69.1,29,14,28,0,812,674,138,815.2
2022-05-24T18:00,69.3,65,2,75,59,673,362,311,560.9
2022-05-24T19:00,69.9,83,1,95,85,634,315,319,366.6
2022-05-24T20:00,68.4,53,0,46,86,472,189,283,290.1
2022-05-24T21:00,67.4,33,0,12,87,467,291,176,323.8
2022-05-24T22:00,67,39,2,23,77,448,318,130,539.3
2022-05-24T23:00,65.4,49,12,26,76,266,185,81,600.5
2022-05-25T00:00,63,51,13,24,84,96,54,42,448.5
2022-05-25T01:00,60.5,68,22,39,84,7,2,5,53.1
2022-05-25T02:00,58.7,76,25,46,85,0,0,0,0
2022-05-25T03:00,57.5,80,31,48,79,0,0,0,0
2022-05-25T04:00,56.6,61,24,51,30,0,0,0,0
2022-05-25T05:00,55.8,48,11,44,39,0,0,0,0
2022-05-25T06:00,55.1,66,16,41,89,0,0,0,0
2022-05-25T07:00,55.4,55,3,39,96,0,0,0,0
2022-05-25T08:00,54.5,47,3,31,85,0,0,0,0
2022-05-25T09:00,54.3,42,5,19,86,0,0,0,0
2022-05-25T10:00,53.8,41,5,12,98,3,1,2,0
2022-05-25T11:00,55.9,40,6,8,100,86,47,39,183.9
2022-05-25T12:00,60.3,47,13,8,100,206,127,79,366.6
2022-05-25T13:00,63.9,42,11,8,91,393,244,149,438.8
2022-05-25T14:00,66.6,56,32,2,86,573,404,169,554.7
2022-05-25T15:00,68.6,100,96,11,95,721,543,178,675.9
2022-05-25T16:00,69.3,100,100,14,98,565,305,260,533.1
2022-05-25T17:00,69.5,100,100,24,89,518,213,305,275.7
2022-05-25T18:00,70.4,100,100,25,57,600,240,360,251
2022-05-25T19:00,69.6,100,100,26,92,316,2,314,133.2
2022-05-25T20:00,70.4,100,98,17,94,312,24,288,6.9
2022-05-25T21:00,70.8,100,94,13,96,276,60,216,59.5
2022-05-25T22:00,71,91,39,45,96,255,61,194,102.7
2022-05-25T23:00,69.6,62,17,28,100,190,73,117,168
2022-05-26T00:00,66.6,70,9,53,99,80,30,50,209
2022-05-26T01:00,63.6,79,7,72,99,7,1,6,31.2
2022-05-26T02:00,62.3,86,1,92,100,0,0,0,0
2022-05-26T03:00,61.5,86,1,92,100,0,0,0,0
2022-05-26T04:00,61.3,77,0,79,99,0,0,0,0
2022-05-26T05:00,60.8,73,0,72,100,0,0,0,0
2022-05-26T06:00,60,64,0,56,100,0,0,0,0
2022-05-26T07:00,60.8,30,0,0,100,0,0,0,0
2022-05-26T08:00,59.7,39,0,15,100,0,0,0,0
2022-05-26T09:00,58.9,54,0,40,100,0,0,0,0
2022-05-26T10:00,58.2,41,0,18,100,3,0,3,0
2022-05-26T11:00,58.2,31,0,2,98,56,16,40,45.2
2022-05-26T12:00,59.3,29,0,1,93,207,106,101,211.1
2022-05-26T13:00,61.2,30,0,0,99,406,284,122,451.2
2022-05-26T14:00,64.1,30,1,0,98,564,442,122,633.5
2022-05-26T15:00,67.5,30,0,3,95,704,505,199,668.3
2022-05-26T16:00,70.2,31,3,6,83,749,498,251,605.3
2022-05-26T17:00,72.8,27,0,4,82,807,566,241,592.7
2022-05-26T18:00,74,45,30,14,32,760,466,294,558.9
2022-05-26T19:00,77.4,100,79,46,12,704,496,208,538.4
2022-05-26T20:00,76.6,44,7,27,73,508,256,252,443.6
2022-05-26T21:00,75.6,44,0,28,89,476,271,205,351.1
2022-05-26T22:00,73.8,29,2,6,80,345,233,112,431.4
2022-05-26T23:00,71.4,35,0,38,41,234,155,79,461.2
2022-05-27T00:00,69.2,56,1,54,77,87,45,42,373
2022-05-27T01:00,67.5,64,6,48,99,6,1,5,47.4
2022-05-27T02:00,66.7,72,3,68,95,0,0,0,0
2022-05-27T03:00,66,52,2,34,98,0,0,0,0
2022-05-27T04:00,65.7,61,16,27,100,0,0,0,0
2022-05-27T05:00,65.6,93,47,35,100,0,0,0,0
2022-05-27T06:00,65.5,78,49,7,99,0,0,0,0
2022-05-27T07:00,66.3,100,39,58,99,0,0,0,0
2022-05-27T08:00,66.2,100,31,100,100,0,0,0,0
2022-05-27T09:00,65.3,99,13,97,98,0,0,0,0
2022-05-27T10:00,64.2,92,6,96,98,1,0,1,0
2022-05-27T11:00,63.8,100,71,94,97,13,0,13,0
2022-05-27T12:00,64.4,100,98,96,100,55,2,53,0.4
2022-05-27T13:00,65.7,100,100,100,100,165,47,118,53.6
2022-05-27T14:00,66.8,100,100,99,100,144,1,143,51.7
2022-05-27T15:00,68.3,100,100,99,100,189,13,176,4.9
2022-05-27T16:00,70.2,100,97,100,100,315,31,284,27.4
2022-05-27T17:00,70.4,100,83,100,100,205,14,191,26.8
2022-05-27T18:00,69.3,100,87,88,100,168,1,167,7.4
2022-05-27T19:00,67.5,100,77,89,100,87,0,87,0.1
2022-05-27T20:00,67.3,100,99,97,100,75,1,74,0.6
2022-05-27T21:00,67.4,100,99,91,100,88,1,87,1.5
2022-05-27T22:00,67,100,68,52,100,63,0,63,0.7
2022-05-27T23:00,66.1,100,73,81,100,54,0,54,0
2022-05-28T00:00,65.3,100,59,84,99,40,3,37,10.2
2022-05-28T01:00,65,67,16,59,58,3,0,3,3.2
2022-05-28T02:00,64.3,23,6,13,31,0,0,0,0
2022-05-28T03:00,62.6,26,1,7,68,0,0,0,0
2022-05-28T04:00,61.2,25,1,8,65,0,0,0,0
2022-05-28T05:00,60.3,25,1,8,64,0,0,0,0
2022-05-28T06:00,59.5,32,1,8,87,0,0,0,0
2022-05-28T07:00,59.2,41,2,36,58,0,0,0,0
2022-05-28T08:00,58.5,43,2,40,56,0,0,0,0
2022-05-28T09:00,58,32,3,31,35,0,0,0,0
2022-05-28T10:00,56.9,66,33,49,22,3,0,3,0
2022-05-28T11:00,59.1,76,55,40,7,61,23,38,73.6
2022-05-28T12:00,65.4,89,88,13,7,144,70,74,193.8
2022-05-28T13:00,62.7,100,98,34,8,181,67,114,182.2
2022-05-28T14:00,62,100,96,44,14,95,9,86,71.3
2022-05-28T15:00,62.3,100,94,68,5,162,14,148,8.8
2022-05-28T16:00,64,100,87,54,1,253,56,197,43.5
2022-05-28T17:00,62.7,100,99,32,0,179,0,179,34.3
2022-05-28T18:00,62.5,85,90,7,0,197,3,194,0
2022-05-28T19:00,65.2,17,19,0,0,554,268,286,145.2
2022-05-28T20:00,66.1,9,10,0,0,549,351,198,378.1
2022-05-28T21:00,67.4,15,17,0,0,563,382,181,507.8
2022-05-28T22:00,67.1,49,54,0,0,419,313,106,592.8
2022-05-28T23:00,66,53,58,1,0,272,192,80,584.9
2022-05-29T00:00,64,27,30,0,0,113,72,41,500.5
2022-05-29T01:00,62.2,3,2,0,3,10,4,6,85.9
2022-05-29T02:00,60.9,10,3,0,23,0,0,0,0
2022-05-29T03:00,61.4,27,0,20,51,0,0,0,0
2022-05-29T04:00,60.3,29,0,0,95,0,0,0,0
2022-05-29T05:00,59.3,29,0,0,96,0,0,0,0
2022-05-29T06:00,55.9,30,0,3,93,0,0,0,0
2022-05-29T07:00,52.7,5,0,0,16,0,0,0,0
2022-05-29T08:00,52,4,0,6,0,0,0,0,0
2022-05-29T09:00,52,4,1,3,3,0,0,0,0
2022-05-29T10:00,52,4,0,5,4,5,1,4,0
2022-05-29T11:00,55.5,12,0,9,21,97,60,37,211
2022-05-29T12:00,61.5,8,0,6,14,265,200,65,513
2022-05-29T13:00,65.7,0,0,0,1,445,359,86,667.6
2022-05-29T14:00,67.8,5,2,0,9,598,514,84,752.5
2022-05-29T15:00,70.1,41,44,3,0,741,622,119,796.5
2022-05-29T16:00,71.9,74,75,11,0,783,553,230,717.1
2022-05-29T17:00,73,82,60,46,0,736,498,238,582.6
2022-05-29T18:00,74.5,67,21,80,0,709,406,303,484.7
2022-05-29T19:00,76.5,57,1,94,0,689,386,303,436.9
2022-05-29T20:00,76.5,3,0,5,0,571,268,303,370.3
2022-05-29T21:00,76.9,0,0,0,0,627,494,133,530.3
2022-05-29T22:00,76.2,0,0,0,0,451,341,110,713.9
2022-05-29T23:00,74,2,1,2,0,281,205,76,624.5
2022-05-30T00:00,71.9,1,0,1,0,117,74,43,520.6
2022-05-30T01:00,68.8,8,0,0,25,10,4,6,91.8
2022-05-30T02:00,66.5,24,0,0,79,0,0,0,0
2022-05-30T03:00,64.7,19,0,0,64,0,0,0,0
2022-05-30T04:00,63,22,0,0,73,0,0,0,0
2022-05-30T05:00,61.8,26,2,2,77,0,0,0,0
2022-05-30T06:00,60.8,13,0,0,42,0,0,0,0
2022-05-30T07:00,60.6,17,0,0,55,0,0,0,0
2022-05-30T08:00,60.2,13,0,0,43,0,0,0,0
2022-05-30T09:00,59.9,21,0,1,69,0,0,0,0
2022-05-30T10:00,59.5,34,0,14,86,4,1,3,0
2022-05-30T11:00,61.9,50,0,56,54,84,37,47,138.6
2022-05-30T12:00,66.9,64,0,87,38,195,108,87,294.5
2022-05-30T13:00,70.6,27,0,34,21,292,153,139,313.7
2022-05-30T14:00,73,5,0,0,18,436,295,141,372.3
2022-05-30T15:00,75.4,0,0,0,1,586,389,197,472.5
2022-05-30T16:00,78.5,1,1,0,0,717,531,186,540.7
2022-05-30T17:00,82,11,7,0,15,903,789,114,731.1
2022-05-30T18:00,84.1,20,15,0,21,907,788,119,859.1
2022-05-30T19:00,85.8,19,0,0,62,879,774,105,861.9
2022-05-30T20:00,86.4,28,1,0,89,778,673,105,861.6
2022-05-30T21:00,86.4,29,0,0,98,634,531,103,816.8
2022-05-30T22:00,85.5,29,0,0,98,462,367,95,748.8
2022-05-30T23:00,82.6,29,0,0,98,277,195,82,635
2022-05-31T00:00,80.4,30,0,0,100,111,60,51,458.1
2022-05-31T01:00,76.9,30,0,0,100,10,2,8,75
2022-05-31T02:00,74.4,30,0,0,99,0,0,0,0
2022-05-31T03:00,72.6,30,0,0,100,0,0,0,0
2022-05-31T04:00,71.6,30,0,0,99,0,0,0,0
2022-05-31T05:00,71.1,30,0,0,100,0,0,0,0
2022-05-31T06:00,70.3,30,0,0,100,0,0,0,0
2022-05-31T07:00,69.2,30,0,0,100,0,0,0,0
2022-05-31T08:00,68.4,30,0,0,100,0,0,0,0
2022-05-31T09:00,67.6,16,0,0,54,0,0,0,0
2022-05-31T10:00,67.6,16,13,7,1,5,2,3,0
2022-05-31T11:00,69,20,10,9,18,94,57,37,217.4
2022-05-31T12:00,74.4,32,8,8,67,262,199,63,492.6
2022-05-31T13:00,78.1,41,12,12,78,444,365,79,669.4
2022-05-31T14:00,80.9,44,10,16,85,612,519,93,759.8
2022-05-31T15:00,83.4,40,3,14,95,755,645,110,808.4
2022-05-31T16:00,84.8,51,0,40,91,810,670,140,799.3
2022-05-31T17:00,85.5,48,1,31,96,746,567,179,681
2022-05-31T18:00,86.8,46,1,27,97,849,683,166,669
2022-05-31T19:00,87.3,40,1,17,96,774,580,194,702.4
2022-05-31T20:00,87,40,0,19,94,659,475,184,624.5
2022-05-31T21:00,86.3,40,0,18,96,498,343,155,544.7
2022-05-31T22:00,85.5,47,0,33,90,425,311,114,550.2
2022-05-31T23:00,82.9,49,0,40,84,246,173,73,550.8
2022-06-01T00:00,81.4,41,1,25,84,115,66,49,440.6
2022-06-01T01:00,78.3,33,1,13,82,11,4,7,88.4
2022-06-01T02:00,76,28,0,5,84,0,0,0,0
2022-06-01T03:00,73.4,20,1,7,51,0,0,0,0
2022-06-01T04:00,71.8,39,1,27,72,0,0,0,0
2022-06-01T05:00,69.4,52,9,30,85,0,0,0,0
2022-06-01T06:00,68.2,47,8,16,100,0,0,0,0
2022-06-01T07:00,67.8,56,10,28,99,0,0,0,0
2022-06-01T08:00,67,50,8,25,92,0,0,0,0
2022-06-01T09:00,67,20,5,16,20,0,0,0,0
2022-06-01T10:00,66,73,19,84,19,5,1,4,0
2022-06-01T11:00,68.5,75,9,67,89,87,47,40,164.8
2022-06-01T12:00,73.5,64,3,55,94,226,153,73,395.7
2022-06-01T13:00,76.9,55,4,35,100,292,204,88,438.1
2022-06-01T14:00,79.2,57,7,34,100,437,297,140,427.6
2022-06-01T15:00,81,36,0,10,100,532,301,231,418.9
2022-06-01T16:00,83,43,2,19,100,635,334,301,378.9
2022-06-01T17:00,83.6,38,5,5,100,638,339,299,379.8
2022-06-01T18:00,80.4,41,2,15,100,540,181,359,276.3
2022-06-01T19:00,80.1,43,5,15,98,642,266,376,243.3
2022-06-01T20:00,80.4,47,10,17,94,405,156,249,250.6
2022-06-01T21:00,80.2,56,21,14,95,299,159,140,208.7
2022-06-01T22:00,79.3,74,14,54,96,293,137,156,252.8
2022-06-01T23:00,75.1,61,12,35,97,163,60,103,220.8
2022-06-02T00:00,73,100,75,23,96,53,12,41,117
2022-06-02T01:00,71.7,100,100,42,99,6,1,5,15.8
2022-06-02T02:00,70.3,100,100,50,95,0,0,0,0
2022-06-02T03:00,69,100,100,49,98,0,0,0,0
2022-06-02T04:00,68,100,100,71,99,0,0,0,0
2022-06-02T05:00,67.3,100,92,71,90,0,0,0,0
2022-06-02T06:00,65.7,100,76,11,95,0,0,0,0
2022-06-02T07:00,66.4,81,55,2,100,0,0,0,0
2022-06-02T08:00,65.1,59,33,0,99,0,0,0,0
2022-06-02T09:00,63.5,46,18,0,100,0,0,0,0
2022-06-02T10:00,62.2,48,20,0,100,4,0,4,0
2022-06-02T11:00,61.8,41,12,0,100,64,12,52,37.5
2022-06-02T12:00,62.2,35,5,0,100,170,30,140,82.3
2022-06-02T13:00,63.8,35,1,6,100,329,102,227,145.3
2022-06-02T14:00,66.2,35,0,11,95,446,142,304,212.7
2022-06-02T15:00,68.6,32,2,4,92,539,176,363,219.1
2022-06-02T16:00,70.5,36,7,1,96,595,210,385,232.8
2022-06-02T17:00,71.5,31,1,0,100,635,188,447,216.3
2022-06-02T18:00,72.4,29,0,0,96,726,307,419,264.1
2022-06-02T19:00,73.3,9,0,1,29,663,279,384,305.8
2022-06-02T20:00,74.3,13,0,12,20,792,662,130,565.5
2022-06-02T21:00,74.3,2,0,1,5,656,541,115,833.6
2022-06-02T22:00,73.3,1,0,1,1,490,398,92,777.8
2022-06-02T23:00,71.5,1,0,1,0,308,242,66,726.1
2022-06-03T00:00,68.5,16,0,25,4,119,76,43,563.1
2022-06-03T01:00,65.7,45,0,70,10,11,4,7,105.3
2022-06-03T02:00,64,47,0,67,23,0,0,0,0
2022-06-03T03:00,63,26,0,30,27,0,0,0,0
2022-06-03T04:00,62.3,31,3,31,32,0,0,0,0
2022-06-03T05:00,61.6,50,5,61,31,0,0,0,0
2022-06-03T06:00,61,54,13,71,0,0,0,0,0
2022-06-03T07:00,61,24,7,29,0,0,0,0,0
2022-06-03T08:00,59.8,6,1,8,0,0,0,0,0
2022-06-03T09:00,58.1,2,1,1,0,0,0,0,0
2022-06-03T10:00,56.8,3,3,0,0,6,2,4,0
2022-06-03T11:00,57,16,18,0,0,105,66,39,246.1
2022-06-03T12:00,58.6,38,42,0,0,243,167,76,477.6
2022-06-03T13:00,60.8,39,43,0,0,357,232,125,495
2022-06-03T14:00,62.7,74,82,0,0,399,120,279,324.5
2022-06-03T15:00,64.1,82,88,5,0,384,71,313,121.8
2022-06-03T16:00,66,65,50,33,0,498,147,351,120.1
2022-06-03T17:00,67.4,47,26,40,0,544,243,301,213.2
2022-06-03T18:00,68.4,41,12,51,0,606,322,284,298.3
2022-06-03T19:00,70.3,29,7,38,0,668,485,183,449.9
2022-06-03T20:00,69.7,12,3,16,0,557,380,177,513
2022-06-03T21:00,70,20,1,32,0,542,400,142,524.4
2022-06-03T22:00,69.5,14,0,24,0,453,332,121,611.7
2022-06-03T23:00,68.4,8,0,13,0,292,227,65,639.2
2022-06-04T00:00,66.7,0,0,0,0,129,84,45,561.9
2022-06-04T01:00,66.5,0,0,0,0,14,7,7,124.2
2022-06-04T02:00,65.1,0,0,0,0,0,0,0,0
2022-06-04T03:00,61,1,0,1,0,0,0,0,0
2022-06-04T04:00,57.9,2,0,4,0,0,0,0,0
2022-06-04T05:00,56.6,5,0,8,0,0,0,0,0
2022-06-04T06:00,55.8,2,0,4,0,0,0,0,0
2022-06-04T07:00,56.2,5,0,8,0,0,0,0,0
2022-06-04T08:00,56.1,9,0,15,0,0,0,0,0
2022-06-04T09:00,56.1,10,0,16,0,0,0,0,0
2022-06-04T10:00,55.8,7,2,8,0,6,2,4,0
2022-06-04T11:00,57.1,7,6,2,0,105,66,39,237.1
2022-06-04T12:00,58.2,0,0,0,0,282,217,65,541.7
2022-06-04T13:00,60.3,0,0,0,0,477,396,81,720.4
2022-06-04T14:00,62.9,0,0,0,0,665,574,91,827.7
2022-06-04T15:00,65.3,0,0,0,0,820,722,98,893.3
2022-06-04T16:00,67.2,0,0,0,0,931,827,104,928
2022-06-04T17:00,68.5,0,0,0,0,990,883,107,944.9
2022-06-04T18:00,69.5,0,0,0,0,994,889,105,951.8
2022-06-04T19:00,69.6,6,0,0,20,942,838,104,947.9
2022-06-04T20:00,69.2,0,0,0,0,836,733,103,926.4
2022-06-04T21:00,68.1,0,0,0,0,693,602,91,897.9
2022-06-04T22:00,66.6,0,0,0,0,515,435,80,855.2
2022-06-04T23:00,64.4,0,0,0,0,323,256,67,771.7
2022-06-05T00:00,61.5,0,0,0,0,139,95,44,625.9
2022-06-05T01:00,59.1,0,0,0,0,15,7,8,142.2
2022-06-05T02:00,57.1,0,0,0,0,0,0,0,0
2022-06-05T03:00,56.6,0,0,0,0,0,0,0,0
2022-06-05T04:00,54.7,0,0,0,0,0,0,0,0
2022-06-05T05:00,54.1,0,0,0,0,0,0,0,0
2022-06-05T06:00,53.1,0,0,0,0,0,0,0,0
2022-06-05T07:00,52.3,0,0,0,0,0,0,0,0
2022-06-05T08:00,54.1,5,0,6,4,0,0,0,0
2022-06-05T09:00,54.1,11,0,15,5,0,0,0,0
2022-06-05T10:00,53.6,4,0,0,13,7,2,5,0
2022-06-05T11:00,53.1,4,0,0,12,108,70,38,251
2022-06-05T12:00,58.7,3,0,0,10,275,205,70,535.5
2022-06-05T13:00,63,2,0,0,5,471,392,79,696
2022-06-05T14:00,65.7,1,0,0,2,643,555,88,810.7
2022-06-05T15:00,67.9,4,0,0,13,797,688,109,860.9
2022-06-05T16:00,68.9,3,0,0,10,784,692,92,826.4
2022-06-05T17:00,71.2,0,0,0,0,942,818,124,825.6
2022-06-05T18:00,72.8,13,0,21,0,971,868,103,913.3
2022-06-05T19:00,74.6,50,0,83,0,848,708,140,882.7
2022-06-05T20:00,73.6,50,0,84,0,542,295,247,572.9
2022-06-05T21:00,73.7,41,0,67,1,537,332,205,402.9
2022-06-05T22:00,73,34,0,54,5,432,312,120,550.5
2022-06-05T23:00,70.2,40,0,61,11,233,124,109,474.9
2022-06-06T00:00,68.9,74,0,85,75,107,46,61,293.5
2022-06-06T01:00,66.3,66,0,79,62,13,3,10,70.4
2022-06-06T02:00,63.2,50,0,83,0,0,0,0,0
2022-06-06T03:00,61,60,0,100,0,0,0,0,0
2022-06-06T04:00,59.6,62,0,99,10,0,0,0,0
2022-06-06T05:00,58.9,60,0,94,13,0,0,0,0
2022-06-06T06:00,57.7,59,0,98,1,0,0,0,0
2022-06-06T07:00,59.2,59,0,98,1,0,0,0,0
2022-06-06T08:00,59.1,70,0,100,32,0,0,0,0
2022-06-06T09:00,58.2,62,0,99,7,0,0,0,0
2022-06-06T10:00,57.3,66,0,77,65,4,1,3,0
2022-06-06T11:00,59.2,66,0,61,99,55,24,31,87.5
2022-06-06T12:00,63.9,41,0,19,100,166,105,61,229.9
2022-06-06T13:00,68.5,12,0,20,0,319,231,88,389.6
2022-06-06T14:00,71.6,22,0,35,4,443,307,136,461.9
2022-06-06T15:00,74.2,19,0,19,26,597,431,166,500.4
2022-06-06T16:00,76.5,25,0,8,66,743,561,182,593.6
2022-06-06T17:00,78.3,37,0,13,98,794,591,203,637.3
2022-06-06T18:00,79.5,56,0,43,99,828,636,192,677.3
2022-06-06T19:00,78.5,52,0,38,98,460,175,285,441
2022-06-06T20:00,78.4,59,7,39,99,473,219,254,216.8
2022-06-06T21:00,77.7,53,3,34,100,370,122,248,227.9
2022-06-06T22:00,76.3,51,3,31,99,302,105,197,187.1
2022-06-06T23:00,74.5,50,1,33,99,170,41,129,155.9
2022-06-07T00:00,71.9,51,0,36,99,84,23,61,117.7
2022-06-07T01:00,69.6,76,0,77,100,10,2,8,37
2022-06-07T02:00,69.1,76,0,77,100,0,0,0,0
2022-06-07T03:00,68.5,74,0,74,100,0,0,0,0
2022-06-07T04:00,67.9,82,0,87,100,0,0,0,0
2022-06-07T05:00,67,89,0,99,100,0,0,0,0
2022-06-07T06:00,66.1,90,0,100,100,0,0,0,0
2022-06-07T07:00,65.5,90,0,100,100,0,0,0,0
2022-06-07T08:00,64.8,88,0,97,98,0,0,0,0
2022-06-07T09:00,64.6,73,0,94,56,0,0,0,0
2022-06-07T10:00,64.1,40,0,57,20,3,0,3,0
2022-06-07T11:00,63.9,55,0,49,86,42,10,32,23.9
2022-06-07T12:00,65.1,60,0,50,99,183,77,106,146.2
2022-06-07T13:00,67.4,87,0,95,100,317,133,184,253.5
2022-06-07T14:00,69.5,70,0,67,100,386,157,229,259.5
2022-06-07T15:00,70.2,65,0,58,100,303,26,277,135.7
2022-06-07T16:00,71.6,83,0,89,100,324,26,298,24
2022-06-07T17:00,70,87,0,99,92,193,0,193,14.2
2022-06-07T18:00,69.7,84,0,100,81,249,14,235,6.8
2022-06-07T19:00,68.4,74,0,97,52,134,0,134,6.4
2022-06-07T20:00,69.2,73,11,97,17,170,38,132,22.7
2022-06-07T21:00,68.3,84,16,100,32,144,29,115,46.1
2022-06-07T22:00,67.6,71,20,69,39,127,30,97,46
2022-06-07T23:00,67.2,75,23,58,64,126,47,79,95.3
2022-06-08T00:00,66.6,80,31,53,69,39,11,28,99.7
2022-06-08T01:00,65.4,96,65,25,75,4,0,4,15.3
2022-06-08T02:00,65.1,100,100,40,64,0,0,0,0
2022-06-08T03:00,64.4,100,100,43,12,0,0,0,0
2022-06-08T04:00,64,94,96,12,2,0,0,0,0
2022-06-08T05:00,63.3,95,99,10,0,0,0,0,0
2022-06-08T06:00,62.4,81,86,6,0,0,0,0,0
2022-06-08T07:00,60.2,53,59,0,0,0,0,0,0
2022-06-08T08:00,58.9,49,54,0,0,0,0,0,0
2022-06-08T09:00,58.2,34,38,0,0,0,0,0,0
2022-06-08T10:00,57.6,25,28,0,0,5,1,4,0
2022-06-08T11:00,57.8,20,22,0,0,74,32,42,106.3
2022-06-08T12:00,58.7,15,17,0,0,239,163,76,345.2
2022-06-08T13:00,60.5,16,18,0,0,392,274,118,524.4
2022-06-08T14:00,63.1,42,47,0,0,526,345,181,537.6
2022-06-08T15:00,65.1,78,77,14,0,559,311,248,459.2
2022-06-08T16:00,67,98,80,32,24,610,303,307,368.4
2022-06-08T17:00,67.7,89,74,36,1,543,209,334,281.7
2022-06-08T18:00,69.1,100,99,62,20,624,235,389,232.7
2022-06-08T19:00,70.8,100,52,62,93,601,220,381,244
2022-06-08T20:00,72,99,36,80,62,630,311,319,311.4
2022-06-08T21:00,72.3,39,16,31,20,540,304,236,407.8
2022-06-08T22:00,72.2,26,0,8,70,472,379,93,587.5
2022-06-08T23:00,70.6,36,3,7,96,269,150,119,585.7
2022-06-09T00:00,67.8,29,0,1,93,88,15,73,238
2022-06-09T01:00,65.7,30,0,0,99,11,0,11,17.2
2022-06-09T02:00,64.4,82,0,87,100,0,0,0,0
2022-06-09T03:00,63.5,87,0,95,100,0,0,0,0
2022-06-09T04:00,63.1,89,0,98,100,0,0,0,0
2022-06-09T05:00,62.6,88,0,96,100,0,0,0,0
2022-06-09T06:00,60.9,92,2,100,100,0,0,0,0
2022-06-09T07:00,58.2,90,0,100,100,0,0,0,0
2022-06-09T08:00,57.9,90,0,100,100,0,0,0,0
2022-06-09T09:00,57.7,84,2,99,76,0,0,0,0
2022-06-09T10:00,57.9,24,0,33,13,1,0,1,0
2022-06-09T11:00,57.9,47,7,66,2,50,19,31,46.3
2022-06-09T12:00,60,100,69,99,1,204,135,69,264.6
2022-06-09T13:00,61.7,100,100,100,0,294,180,114,398.8
2022-06-09T14:00,62.6,100,100,100,0,258,92,166,251.2
2022-06-09T15:00,62.7,100,92,99,0,190,17,173,70.2
2022-06-09T16:00,63,100,72,83,0,245,57,188,40.4
2022-06-09T17:00,62.5,100,92,41,0,163,2,161,35.7
2022-06-09T18:00,61.7,73,49,48,0,162,2,160,0.1
2022-06-09T19:00,62.9,72,37,65,0,433,174,259,89.5
2022-06-09T20:00,61.8,58,41,35,0,479,300,179,281.3
2022-06-09T21:00,63.2,73,48,49,0,511,381,130,470.8
2022-06-09T22:00,63.9,59,32,50,0,385,261,124,533
2022-06-09T23:00,63.2,62,25,65,0,218,135,83,429.1
2022-06-10T00:00,62.4,35,11,42,0,96,50,46,314.9
2022-06-10T01:00,61.2,37,18,35,0,15,6,9,85.3
2022-06-10T02:00,59.8,52,31,40,0,0,0,0,0
2022-06-10T03:00,58.9,24,12,22,0,0,0,0,0
2022-06-10T04:00,58.1,7,3,7,0,0,0,0,0
2022-06-10T05:00,57.6,3,1,3,0,0,0,0,0
2022-06-10T06:00,57.1,0,0,0,0,0,0,0,0
2022-06-10T07:00,56.7,0,0,0,0,0,0,0,0
2022-06-10T08:00,56.2,1,1,0,0,0,0,0,0
2022-06-10T09:00,55.8,4,4,0,0,0,0,0,0
2022-06-10T10:00,55.5,1,1,0,0,7,2,5,0
2022-06-10T11:00,57,6,7,0,0,104,64,40,226.7
2022-06-10T12:00,59.8,25,24,5,0,268,196,72,496.5
2022-06-10T13:00,62.4,6,5,2,0,464,378,86,668.4
2022-06-10T14:00,64.8,22,10,22,0,611,507,104,759.4
2022-06-10T15:00,66.5,46,36,22,0,730,627,103,788.2
2022-06-10T16:00,68,46,30,31,0,713,507,206,682.3
2022-06-10T17:00,69.1,42,17,45,0,819,627,192,611.9
2022-06-10T18:00,70.7,31,10,36,0,861,660,201,697.3
2022-06-10T19:00,70.1,34,11,40,0,683,519,164,643
2022-06-10T20:00,70.5,55,2,83,12,685,497,188,595.1
2022-06-10T21:00,70.2,66,2,88,38,533,352,181,561.7
2022-06-10T22:00,70,40,2,53,20,441,308,133,543.3
2022-06-10T23:00,68.2,40,5,52,13,262,154,108,501.5
2022-06-11T00:00,66.8,46,9,43,41,125,68,57,386.3
2022-06-11T01:00,64.7,45,9,27,68,18,8,10,118.5
2022-06-11T02:00,61.4,26,1,12,60,0,0,0,0
2022-06-11T03:00,61.6,15,1,6,35,0,0,0,0
2022-06-11T04:00,59.2,7,1,2,17,0,0,0,0
2022-06-11T05:00,56.8,10,0,1,30,0,0,0,0
2022-06-11T06:00,55.5,19,0,8,46,0,0,0,0
2022-06-11T07:00,54.6,23,0,15,46,0,0,0,0
2022-06-11T08:00,53.8,2,0,1,5,0,0,0,0
2022-06-11T09:00,53.2,5,0,2,13,0,0,0,0
2022-06-11T10:00,53.3,42,0,31,79,7,2,5,0
2022-06-11T11:00,55.1,29,0,0,98,94,49,45,183.6
2022-06-11T12:00,61.5,31,0,2,98,248,137,111,364.5
2022-06-11T13:00,65.2,31,0,1,100,393,215,178,418.2
2022-06-11T14:00,67.6,35,0,8,100,513,294,219,434.8
2022-06-11T15:00,69.7,53,5,30,100,595,327,268,424.8
2022-06-11T16:00,71.1,40,0,17,99,700,461,239,467.1
2022-06-11T17:00,71.3,49,10,38,57,718,453,265,504.4
2022-06-11T18:00,72.3,68,24,64,28,779,548,231,544.6
2022-06-11T19:00,71.7,42,17,34,22,457,266,191,440.7
2022-06-11T20:00,72,41,9,45,21,584,368,216,367.4
2022-06-11T21:00,70.3,33,5,44,6,419,221,198,381
2022-06-11T22:00,69.4,47,1,63,26,448,347,101,481.7
2022-06-11T23:00,67.8,36,2,45,24,256,166,90,564.8
2022-06-12T00:00,65.8,23,0,22,33,114,69,45,402.8
2022-06-12T01:00,63.8,8,0,14,0,16,7,9,119.5
2022-06-12T02:00,62.5,15,0,20,9,0,0,0,0
2022-06-12T03:00,61.6,31,0,2,100,0,0,0,0
2022-06-12T04:00,60.7,32,0,4,100,0,0,0,0
2022-06-12T05:00,60.2,33,0,5,100,0,0,0,0
2022-06-12T06:00,59.5,32,0,4,100,0,0,0,0
2022-06-12T07:00,59.4,31,0,1,100,0,0,0,0
2022-06-12T08:00,59.2,34,0,6,100,0,0,0,0
2022-06-12T09:00,58.7,38,0,13,100,0,0,0,0
2022-06-12T10:00,58.5,44,0,27,94,5,0,5,0
2022-06-12T11:00,59.4,21,0,11,48,81,27,54,67.1
2022-06-12T12:00,63,6,0,0,19,261,182,79,354.6
2022-06-12T13:00,66.4,15,0,0,49,433,323,110,596.7
2022-06-12T14:00,69.7,11,0,1,33,627,516,111,714.1
2022-06-12T15:00,72.4,10,2,0,28,723,528,195,730.6
2022-06-12T16:00,74.4,30,7,1,78,766,567,199,665.9
2022-06-12T17:00,74.5,50,38,9,33,539,245,294,454.3
2022-06-12T18:00,74.7,66,51,27,12,489,248,241,244.4
2022-06-12T19:00,74,76,32,33,91,565,306,259,303.8
2022-06-12T20:00,74.5,63,23,24,92,430,249,181,330.5
2022-06-12T21:00,71.9,74,29,40,79,419,160,259,275.4
2022-06-12T22:00,69.8,78,10,70,91,193,32,161,142
2022-06-12T23:00,69.1,52,2,33,100,144,37,107,75.7
2022-06-13T00:00,67.8,44,2,24,91,55,2,53,56.9
2022-06-13T01:00,66.6,36,1,11,96,8,1,7,2.1
2022-06-13T02:00,65.6,63,8,45,97,0,0,0,0
2022-06-13T03:00,64.5,56,14,28,90,0,0,0,0
2022-06-13T04:00,63.7,52,14,24,82,0,0,0,0
2022-06-13T05:00,63.4,39,8,18,69,0,0,0,0
2022-06-13T06:00,63.2,29,22,9,14,0,0,0,0
2022-06-13T07:00,62.4,32,34,3,0,0,0,0,0
2022-06-13T08:00,62.1,40,44,0,1,0,0,0,0
2022-06-13T09:00,60.2,65,71,0,2,0,0,0,0
2022-06-13T10:00,60.6,89,98,2,0,4,0,4,0
2022-06-13T11:00,63,60,58,0,27,38,1,37,1
2022-06-13T12:00,63.4,49,40,0,42,92,16,76,23.1
2022-06-13T13:00,63.8,33,36,0,1,222,69,153,82.5
2022-06-13T14:00,65.1,43,44,0,12,431,253,178,254
2022-06-13T15:00,67.4,29,27,0,15,611,419,192,454.6
2022-06-13T16:00,69.9,25,23,0,13,828,677,151,650.8
2022-06-13T17:00,71.7,10,10,0,2,915,745,170,787.4
2022-06-13T18:00,73.5,4,3,0,5,966,846,120,852.2
2022-06-13T19:00,75.3,1,1,0,0,901,767,134,881.5
2022-06-13T20:00,75.6,0,0,0,0,822,723,99,871.2
2022-06-13T21:00,75,1,0,0,4,681,590,91,875.5
2022-06-13T22:00,73.4,23,0,0,76,507,424,83,822.8
2022-06-13T23:00,70.9,30,0,0,100,316,239,77,722.1
2022-06-14T00:00,67.6,30,0,0,100,133,71,62,510.8
2022-06-14T01:00,64.8,29,0,0,97,15,2,13,112.9
2022-06-14T02:00,63.1,28,0,0,94,0,0,0,0
2022-06-14T03:00,61.4,20,0,0,66,0,0,0,0
2022-06-14T04:00,61.2,20,0,15,38,0,0,0,0
2022-06-14T05:00,62.5,32,0,13,81,0,0,0,0
2022-06-14T06:00,60.9,29,0,1,94,0,0,0,0
2022-06-14T07:00,59.4,32,0,4,98,0,0,0,0
2022-06-14T08:00,57.8,33,0,5,100,0,0,0,0
2022-06-14T09:00,57.5,33,0,5,100,0,0,0,0
2022-06-14T10:00,56,28,0,0,92,6,1,5,0
2022-06-14T11:00,58.4,17,0,0,57,97,48,49,153.5
2022-06-14T12:00,64,29,0,3,91,269,198,71,450
2022-06-14T13:00,67.2,45,0,38,73,427,320,107,613.7
2022-06-14T14:00,70,33,0,8,95,626,522,104,707.3
2022-06-14T15:00,72.4,28,0,0,93,771,647,124,805.7
2022-06-14T16:00,74.5,14,0,0,48,889,782,107,852.2
2022-06-14T17:00,76,1,0,0,4,944,821,123,883.2
2022-06-14T18:00,77.1,4,4,0,0,962,863,99,899.3
2022-06-14T19:00,77.2,3,3,0,0,910,810,100,913.4
2022-06-14T20:00,77.1,0,0,0,0,813,717,96,892.6
2022-06-14T21:00,76.4,0,0,0,0,673,583,90,863.3
2022-06-14T22:00,75.1,0,0,0,0,503,421,82,811.7
2022-06-14T23:00,73.1,0,0,0,0,320,253,67,732.2
2022-06-15T00:00,70.6,0,0,0,0,143,97,46,593
2022-06-15T01:00,68.3,0,0,0,0,20,9,11,170.6
2022-06-15T02:00,66.4,0,0,0,0,0,0,0,0
2022-06-15T03:00,64.9,4,0,0,12,0,0,0,0
2022-06-15T04:00,66,15,0,0,49,0,0,0,0
2022-06-15T05:00,64.6,25,0,0,83,0,0,0,0
2022-06-15T06:00,62.8,9,0,0,31,0,0,0,0
2022-06-15T07:00,62.3,1,0,1,0,0,0,0,0
2022-06-15T08:00,59,1,0,1,0,0,0,0,0
2022-06-15T09:00,57.5,2,0,3,0,0,0,0,0
2022-06-15T10:00,56.9,4,0,7,0,7,2,5,0
2022-06-15T11:00,60.3,2,0,4,0,103,66,37,231.1
2022-06-15T12:00,67.1,1,0,1,0,271,208,63,522.2
2022-06-15T13:00,71.7,1,0,0,2,453,374,79,681.8
2022-06-15T14:00,75.2,10,0,1,30,625,534,91,774.9
2022-06-15T15:00,77.7,27,0,4,81,758,641,117,810
2022-06-15T16:00,79.9,29,0,2,93,863,727,136,816.9
2022-06-15T17:00,81.8,32,0,3,99,919,763,156,823.1
2022-06-15T18:00,83.2,31,0,2,99,906,707,199,801.8
2022-06-15T19:00,82.9,31,0,1,100,670,318,352,544.6
2022-06-15T20:00,83.8,33,4,1,97,702,475,227,445.6
2022-06-15T21:00,84.2,39,16,8,66,612,479,133,647.8
2022-06-15T22:00,83.6,20,3,7,42,453,345,108,676
2022-06-15T23:00,80.9,6,2,5,5,246,163,83,537.8
2022-06-16T00:00,77.9,4,0,5,4,110,68,42,390.7
2022-06-16T01:00,75.2,38,12,32,25,12,5,7,119
2022-06-16T02:00,74.1,64,16,45,74,0,0,0,0
2022-06-16T03:00,73,62,9,40,99,0,0,0,0
2022-06-16T04:00,71.9,72,31,24,100,0,0,0,0
2022-06-16T05:00,70.1,100,93,73,99,0,0,0,0
2022-06-16T06:00,69.7,98,70,8,100,0,0,0,0
2022-06-16T07:00,69.4,82,42,23,100,0,0,0,0
2022-06-16T08:00,69.1,36,0,10,100,0,0,0,0
2022-06-16T09:00,68.3,34,1,7,97,0,0,0,0
2022-06-16T10:00,67.6,37,2,10,97,5,0,5,0
2022-06-16T11:00,67.6,45,1,31,85,64,20,44,52.2
2022-06-16T12:00,68.6,45,3,28,86,187,115,72,230.7
2022-06-16T13:00,71.4,33,8,13,61,382,250,132,423.3
2022-06-16T14:00,74.8,44,13,11,87,532,354,178,515.5
2022-06-16T15:00,78.3,25,8,1,57,681,493,188,579.2
2022-06-16T16:00,81.4,33,12,0,75,788,560,228,632.3
2022-06-16T17:00,83.9,25,14,0,41,829,591,238,638.6
2022-06-16T18:00,84.7,43,34,9,23,695,485,210,572.6
2022-06-16T19:00,84.3,69,44,37,24,755,526,229,545.8
2022-06-16T20:00,84.7,69,32,18,98,654,469,185,595.6
2022-06-16T21:00,83.1,66,28,18,100,410,193,217,440.4
2022-06-16T22:00,76.2,56,15,21,100,72,0,72,127.1
2022-06-16T23:00,74.5,66,18,33,100,70,16,54,12.7
2022-06-17T00:00,74.2,100,39,69,94,54,8,46,44
2022-06-17T01:00,73.8,65,19,43,72,11,1,10,15
2022-06-17T02:00,73.2,36,8,24,47,0,0,0,0
2022-06-17T03:00,72.4,6,2,5,3,0,0,0,0
2022-06-17T04:00,71.6,1,0,1,0,0,0,0,0
2022-06-17T05:00,71.1,0,0,0,0,0,0,0,0
2022-06-17T06:00,70.4,1,0,1,0,0,0,0,0
2022-06-17T07:00,71.1,17,0,29,0,0,0,0,0
2022-06-17T08:00,70.8,13,0,22,0,0,0,0,0
2022-06-17T09:00,70.6,4,0,6,0,0,0,0,0
2022-06-17T10:00,70.2,6,3,5,0,7,2,5,0
2022-06-17T11:00,71,11,7,8,0,92,55,37,197.5
2022-06-17T12:00,72.9,2,2,1,0,262,194,68,465.6
2022-06-17T13:00,74.5,13,0,21,0,427,347,80,637.7
2022-06-17T14:00,75.3,29,2,45,0,583,483,100,717.7
2022-06-17T15:00,75.4,29,9,35,0,584,440,144,648.1
2022-06-17T16:00,75.7,30,1,48,0,620,448,172,520.9
2022-06-17T17:00,77.1,27,3,41,0,790,566,224,548.9
2022-06-17T18:00,77.7,22,4,30,0,839,674,165,665.6
2022-06-17T19:00,77.7,17,3,24,0,762,630,132,714.2
2022-06-17T20:00,77.4,15,1,23,0,680,565,115,696.7
2022-06-17T21:00,76.8,11,0,18,0,588,471,117,688.4
2022-06-17T22:00,76.1,38,0,64,0,433,326,107,645.1
2022-06-17T23:00,73.8,42,4,64,0,226,159,67,515.8
2022-06-18T00:00,71.8,50,19,55,0,81,48,33,328.3
2022-06-18T01:00,70.1,41,16,44,0,16,7,9,88.8
2022-06-18T02:00,68.4,31,16,28,0,0,0,0,0
2022-06-18T03:00,66.6,22,16,12,0,0,0,0,0
2022-06-18T04:00,64.2,68,51,37,0,0,0,0,0
2022-06-18T05:00,62.2,100,100,79,0,0,0,0,0
2022-06-18T06:00,60.9,100,100,75,2,0,0,0,0
2022-06-18T07:00,59.9,100,100,61,2,0,0,0,0
2022-06-18T08:00,57.7,100,99,50,16,0,0,0,0
2022-06-18T09:00,56.5,100,100,64,42,0,0,0,0
2022-06-18T10:00,56,100,100,100,24,2,0,2,0
2022-06-18T11:00,55.8,100,100,100,5,19,0,19,0
2022-06-18T12:00,55.6,100,100,100,0,50,0,50,0
2022-06-18T13:00,55.3,100,100,100,0,96,0,96,0
2022-06-18T14:00,54.6,100,100,97,0,106,10,96,8.1
2022-06-18T15:00,54.2,100,100,69,0,131,0,131,6.5
2022-06-18T16:00,54.4,99,100,15,0,218,41,177,21
2022-06-18T17:00,55.7,91,100,1,0,335,69,266,59.5
2022-06-18T18:00,57,60,66,1,0,357,122,235,92.6
2022-06-18T19:00,60.2,19,20,2,0,640,330,310,242
2022-06-18T20:00,61.9,7,5,4,0,674,432,242,444.8
2022-06-18T21:00,62.6,6,2,7,0,688,564,124,673.1
2022-06-18T22:00,62.8,1,0,2,0,540,458,82,845.1
2022-06-18T23:00,61.9,1,0,2,0,321,235,86,741.1
2022-06-19T00:00,60.4,1,0,1,0,137,89,48,533
2022-06-19T01:00,59.1,2,0,4,0,21,11,10,165.3
2022-06-19T02:00,58,3,1,3,0,0,0,0,0
2022-06-19T03:00,57.5,0,0,0,0,0,0,0,0
2022-06-19T04:00,56.8,0,0,0,0,0,0,0,0
2022-06-19T05:00,56.1,0,0,0,0,0,0,0,0
2022-06-19T06:00,55.8,1,1,0,0,0,0,0,0
2022-06-19T07:00,54.3,1,1,0,0,0,0,0,0
2022-06-19T08:00,53.4,0,0,0,0,0,0,0,0
2022-06-19T09:00,52.6,3,3,0,0,0,0,0,0
2022-06-19T10:00,52.1,3,3,0,0,7,3,4,0
2022-06-19T11:00,52.8,2,2,0,0,111,71,40,266.6
2022-06-19T12:00,54.4,2,2,0,0,288,223,65,563.4
2022-06-19T13:00,56.4,23,26,0,0,473,387,86,725.7
2022-06-19T14:00,58.1,15,17,0,0,609,459,150,729.8
2022-06-19T15:00,59.9,10,11,0,0,775,615,160,729.2
2022-06-19T16:00,61.6,11,12,0,0,903,749,154,813.2
2022-06-19T17:00,63,4,4,0,0,976,855,121,883.7
2022-06-19T18:00,64,2,1,0,2,986,866,120,921.4
2022-06-19T19:00,64.9,0,0,0,0,936,821,115,919.9
2022-06-19T20:00,64.8,3,0,0,10,794,693,101,880.8
2022-06-19T21:00,65,2,0,0,5,692,587,105,844.3
2022-06-19T22:00,64.8,14,0,0,45,527,445,82,831.9
2022-06-19T23:00,63.9,12,0,0,41,343,276,67,780.2
2022-06-20T00:00,62,24,0,0,80,154,104,50,634.5
2022-06-20T01:00,59.7,20,0,0,67,22,8,14,185.6
2022-06-20T02:00,58.1,1,0,0,2,0,0,0,0
2022-06-20T03:00,56.9,0,0,0,0,0,0,0,0
2022-06-20T04:00,56,2,0,0,7,0,0,0,0
2022-06-20T05:00,55.3,0,0,0,0,0,0,0,0
2022-06-20T06:00,54.8,0,0,0,0,0,0,0,0
2022-06-20T07:00,54.3,0,0,0,0,0,0,0,0
2022-06-20T08:00,53.8,24,0,0,79,0,0,0,0
2022-06-20T09:00,53.2,23,0,0,76,0,0,0,0
2022-06-20T10:00,51.9,3,0,0,9,7,2,5,0
2022-06-20T11:00,54.3,2,0,1,4,104,63,41,223.2
2022-06-20T12:00,58.9,1,0,1,2,283,215,68,525.7
2022-06-20T13:00,62.3,9,0,1,28,471,392,79,715.1
2022-06-20T14:00,65.4,4,0,6,2,642,551,91,808.1
2022-06-20T15:00,68.3,3,0,5,0,790,673,117,847.2
2022-06-20T16:00,70.3,25,0,7,68,873,704,169,824.2
2022-06-20T17:00,72,6,0,0,20,944,783,161,817.4
2022-06-20T18:00,73.1,10,0,0,34,931,737,194,809
2022-06-20T19:00,74.1,1,0,1,0,919,798,121,833.1
2022-06-20T20:00,74.5,0,0,0,0,821,708,113,880.9
2022-06-20T21:00,74.1,0,0,0,0,691,604,87,869.5
2022-06-20T22:00,73.4,9,0,0,31,514,427,87,827.8
2022-06-20T23:00,71.3,0,0,0,0,331,264,67,743.1
2022-06-21T00:00,68.4,5,0,0,17,152,105,47,616.7
2022-06-21T01:00,66.1,8,0,0,25,23,11,12,193.7
2022-06-21T02:00,63.8,14,0,0,46,0,0,0,0
2022-06-21T03:00,61.7,5,0,0,18,0,0,0,0
2022-06-21T04:00,59.6,19,0,0,64,0,0,0,0
2022-06-21T05:00,58.2,26,0,0,87,0,0,0,0
2022-06-21T06:00,58,26,0,0,88,0,0,0,0
2022-06-21T07:00,57.7,32,2,0,100,0,0,0,0
2022-06-21T08:00,57.5,40,11,0,100,0,0,0,0
2022-06-21T09:00,57.3,52,21,5,100,0,0,0,0
2022-06-21T10:00,57.8,100,83,66,100,3,0,3,0
2022-06-21T11:00,59.5,99,79,31,31,40,0,40,0
2022-06-21T12:00,62.3,100,81,49,83,127,18,109,19.8
2022-06-21T13:00,65.8,52,25,4,91,282,108,174,122.4
2022-06-21T14:00,70.2,31,0,2,99,523,336,187,367.5
2022-06-21T15:00,72.8,32,2,0,100,588,357,231,498.6
2022-06-21T16:00,75.2,40,13,0,95,605,282,323,380.3
2022-06-21T17:00,77.4,34,7,0,93,628,394,234,360.4
2022-06-21T18:00,80.2,32,5,2,86,745,485,260,463.4
2022-06-21T19:00,83.3,20,2,2,57,850,658,192,624.7
2022-06-21T20:00,85,27,18,2,31,766,616,150,753.2
2022-06-21T21:00,86.2,70,44,50,0,608,489,119,732.6
2022-06-21T22:00,85.8,7,7,1,2,442,333,109,651.6
2022-06-21T23:00,83.9,4,3,2,0,314,245,69,631.9
2022-06-22T00:00,80.9,0,0,0,0,134,86,48,546.8
2022-06-22T01:00,77.3,0,0,0,0,21,10,11,159.9
2022-06-22T02:00,74.4,2,0,0,6,0,0,0,0
2022-06-22T03:00,72.9,5,0,0,18,0,0,0,0
2022-06-22T04:00,70.9,6,0,0,20,0,0,0,0
2022-06-22T05:00,68.6,5,0,4,10,0,0,0,0
2022-06-22T06:00,67.5,13,2,7,24,0,0,0,0
2022-06-22T07:00,66.7,27,3,13,54,0,0,0,0
2022-06-22T08:00,66.5,47,6,32,75,0,0,0,0
2022-06-22T09:00,66.1,50,13,24,80,0,0,0,0
2022-06-22T10:00,66,41,9,8,92,5,1,4,0
2022-06-22T11:00,67.5,29,0,0,96,55,4,51,20.4
2022-06-22T12:00,70.6,28,0,0,93,187,96,91,142.4
2022-06-22T13:00,75.3,38,8,8,86,393,286,107,437.3
2022-06-22T14:00,78.4,48,12,17,91,491,353,138,563.6
2022-06-22T15:00,81.7,53,13,23,92,585,403,182,520.6
2022-06-22T16:00,83.7,47,16,22,63,669,471,198,525.4
2022-06-22T17:00,83.3,61,21,35,69,610,403,207,483.5
2022-06-22T18:00,82.6,50,26,25,38,622,430,192,433.4
2022-06-22T19:00,85.9,38,24,19,16,722,555,167,533.7
2022-06-22T20:00,85.7,41,27,15,25,704,563,141,666.9
2022-06-22T21:00,82.8,91,49,54,48,478,338,140,597.9
2022-06-22T22:00,78.6,100,65,41,66,289,177,112,405.7
2022-06-22T23:00,75.6,81,53,32,46,142,38,104,210.7
2022-06-23T00:00,72.7,49,16,40,36,36,0,36,39.6
2022-06-23T01:00,69.3,53,27,30,34,11,2,9,0
2022-06-23T02:00,66.8,80,50,51,15,0,0,0,0
2022-06-23T03:00,65.3,100,99,74,20,0,0,0,0
2022-06-23T04:00,64.6,100,100,60,31,0,0,0,0
2022-06-23T05:00,63.7,100,90,56,47,0,0,0,0
2022-06-23T06:00,63.6,100,83,62,21,0,0,0,0
2022-06-23T07:00,63.5,85,64,45,0,0,0,0,0
2022-06-23T08:00,63.5,83,66,39,0,0,0,0,0
2022-06-23T09:00,63.5,70,62,21,5,0,0,0,0
2022-06-23T10:00,63.5,96,58,39,69,4,1,3,0
2022-06-23T11:00,63.8,100,40,66,95,59,28,31,108.8
2022-06-23T12:00,64.4,59,27,26,65,102,52,50,169.9
2022-06-23T13:00,65,39,38,0,17,237,123,114,188.8
2022-06-23T14:00,66.7,42,47,0,0,456,315,141,359.3
2022-06-23T15:00,68.1,43,48,0,0,577,439,138,525.5
2022-06-23T16:00,70.2,37,41,0,0,712,506,206,569
2022-06-23T17:00,71.3,64,71,0,0,720,521,199,570.5
2022-06-23T18:00,71.8,70,61,25,0,669,439,230,507.9
2022-06-23T19:00,75.8,71,62,26,0,730,519,211,522.3
2022-06-23T20:00,76.2,65,54,27,0,584,367,217,514.7
2022-06-23T21:00,76.4,56,40,34,0,519,369,150,484
2022-06-23T22:00,74.7,50,30,38,1,371,271,100,516
2022-06-23T23:00,73.5,17,11,12,1,265,176,89,482.4
2022-06-24T00:00,71.2,25,16,16,4,112,68,44,402.5
2022-06-24T01:00,69.5,13,11,5,0,20,10,10,132.9
2022-06-24T02:00,67.7,19,16,7,0,0,0,0,0
2022-06-24T03:00,66.4,13,10,7,0,0,0,0,0
2022-06-24T04:00,65.2,9,6,6,0,0,0,0,0
2022-06-24T05:00,64.6,6,3,5,0,0,0,0,0
2022-06-24T06:00,64.3,2,0,4,0,0,0,0,0
2022-06-24T07:00,63.6,2,1,1,0,0,0,0,0
2022-06-24T08:00,63,2,2,0,0,0,0,0,0
2022-06-24T09:00,62.8,1,1,0,0,0,0,0,0
2022-06-24T10:00,62.5,1,1,0,0,6,2,4,0
2022-06-24T11:00,63.9,0,0,0,0,95,59,36,219.7
2022-06-24T12:00,69.3,0,0,0,0,249,174,75,456.4
2022-06-24T13:00,72.9,0,0,0,0,435,346,89,608.8
2022-06-24T14:00,75.6,0,0,0,0,599,480,119,711.2
2022-06-24T15:00,78,0,0,0,0,754,634,120,766.2
2022-06-24T16:00,79.7,8,8,1,0,862,737,125,833.8
2022-06-24T17:00,80.3,20,17,7,0,801,540,261,708.7
2022-06-24T18:00,81.1,13,6,13,0,812,588,224,586.5
2022-06-24T19:00,82.1,14,2,21,0,830,657,173,678
2022-06-24T20:00,82.7,3,0,5,0,774,609,165,735.1
2022-06-24T21:00,82.7,3,0,4,1,699,618,81,816.6
2022-06-24T22:00,81.6,3,0,0,10,525,450,75,863.7
2022-06-24T23:00,79.4,5,0,0,16,330,263,67,760.4
2022-06-25T00:00,76.1,21,0,0,69,152,105,47,608.8
2022-06-25T01:00,72.9,25,1,0,80,23,12,11,198.6
2022-06-25T02:00,70.5,9,0,0,30,0,0,0,0
2022-06-25T03:00,69.3,8,0,0,28,0,0,0,0
2022-06-25T04:00,69.2,0,0,0,1,0,0,0,0
2022-06-25T05:00,67.5,0,0,0,0,0,0,0,0
2022-06-25T06:00,64.6,0,0,0,0,0,0,0,0
2022-06-25T07:00,64.8,0,0,0,0,0,0,0,0
2022-06-25T08:00,63,1,1,0,0,0,0,0,0
2022-06-25T09:00,62.1,0,0,0,0,0,0,0,0
2022-06-25T10:00,60.3,0,0,0,0,6,2,4,0
2022-06-25T11:00,62.9,0,0,0,0,102,65,37,238.6
2022-06-25T12:00,69.6,1,0,0,2,269,207,62,530.2
2022-06-25T13:00,74.5,0,0,0,1,453,375,78,690.7
2022-06-25T14:00,77.9,0,0,0,0,627,537,90,783.7
2022-06-25T15:00,80.8,0,0,0,0,774,676,98,838.7
2022-06-25T16:00,82.8,0,0,0,0,882,777,105,871.2
2022-06-25T17:00,84.6,0,0,0,0,942,834,108,888.3
2022-06-25T18:00,86.1,0,0,0,0,953,848,105,898.9
2022-06-25T19:00,86.8,0,0,0,1,905,802,103,898.8
2022-06-25T20:00,87.3,3,0,0,11,792,690,102,867.4
2022-06-25T21:00,87.2,14,0,0,48,667,576,91,836
2022-06-25T22:00,86.4,23,0,0,77,485,401,84,780
2022-06-25T23:00,84,27,0,0,90,323,251,72,700.8
2022-06-26T00:00,80.5,26,0,0,88,137,86,51,546.9
2022-06-26T01:00,77.3,22,0,0,74,22,10,12,160
2022-06-26T02:00,74.7,23,0,0,76,0,0,0,0
2022-06-26T03:00,72.9,27,0,0,89,0,0,0,0
2022-06-26T04:00,71.6,28,0,0,94,0,0,0,0
2022-06-26T05:00,70.6,26,0,0,88,0,0,0,0
2022-06-26T06:00,69.9,25,0,0,83,0,0,0,0
2022-06-26T07:00,69.4,8,0,0,26,0,0,0,0
2022-06-26T08:00,69.3,2,0,0,8,0,0,0,0
2022-06-26T09:00,69.1,11,0,0,38,0,0,0,0
2022-06-26T10:00,69,23,1,0,73,6,1,5,0
2022-06-26T11:00,70.9,29,3,3,80,93,49,44,175.8
2022-06-26T12:00,74.1,33,15,12,40,212,116,96,341.5
2022-06-26T13:00,77.3,26,8,7,47,346,236,110,413
2022-06-26T14:00,79.8,41,10,11,84,453,287,166,452.8
2022-06-26T15:00,82.6,22,3,7,49,634,456,178,499.5
2022-06-26T16:00,84.3,37,14,35,11,780,637,143,661.2
2022-06-26T17:00,85.8,35,5,44,12,739,563,176,670.2
2022-06-26T18:00,86.8,65,6,53,93,749,571,178,605
2022-06-26T19:00,87.4,44,4,29,77,620,452,168,555.8
2022-06-26T20:00,87.9,26,1,23,38,571,410,161,498.3
2022-06-26T21:00,83.5,67,17,74,23,456,328,128,498.1
2022-06-26T22:00,80.4,55,3,44,86,227,89,138,316.8
2022-06-26T23:00,78,99,65,23,90,145,64,81,158.3
2022-06-27T00:00,75.8,100,69,60,97,43,3,40,92.7
2022-06-27T01:00,74.5,100,66,56,95,9,1,8,2.2
2022-06-27T02:00,73.8,100,42,58,93,0,0,0,0
2022-06-27T03:00,73,90,48,45,65,0,0,0,0
2022-06-27T04:00,72.6,73,30,39,76,0,0,0,0
2022-06-27T05:00,72.2,75,32,29,96,0,0,0,0
2022-06-27T06:00,71.8,100,62,38,91,0,0,0,0
2022-06-27T07:00,71.8,100,72,50,99,0,0,0,0
2022-06-27T08:00,71.1,100,100,91,98,0,0,0,0
2022-06-27T09:00,70.2,100,97,98,96,0,0,0,0
2022-06-27T10:00,68.9,100,52,62,96,1,0,1,0
2022-06-27T11:00,66.1,38,12,4,81,36,8,28,20.2
2022-06-27T12:00,65.1,28,3,1,82,146,59,87,102.2
2022-06-27T13:00,66.6,26,1,0,82,413,269,144,351.5
2022-06-27T14:00,68.9,20,1,0,62,619,496,123,658.4
2022-06-27T15:00,71.3,59,49,20,9,740,614,126,786.3
2022-06-27T16:00,72.8,100,93,69,0,724,491,233,676.7
2022-06-27T17:00,74.3,93,50,80,0,759,422,337,498.9
2022-06-27T18:00,75,99,44,99,0,639,377,262,426.9
2022-06-27T19:00,75.4,81,33,85,0,612,276,336,351.8
2022-06-27T20:00,74.6,50,5,76,0,529,265,264,306
2022-06-27T21:00,73.5,48,17,54,0,499,311,188,383.7
2022-06-27T22:00,71.8,57,12,77,0,398,249,149,457.3
2022-06-27T23:00,70.2,63,23,71,0,243,141,102,423.3
2022-06-28T00:00,68.3,74,29,80,0,76,21,55,238.3
2022-06-28T01:00,66.7,100,95,87,0,8,1,7,31.3
2022-06-28T02:00,65.7,76,26,88,0,0,0,0,0
2022-06-28T03:00,64.8,40,3,62,0,0,0,0,0
2022-06-28T04:00,63.8,21,2,32,0,0,0,0,0
2022-06-28T05:00,62.3,17,3,24,0,0,0,0,0
2022-06-28T06:00,61.2,28,11,30,0,0,0,0,0
2022-06-28T07:00,60.1,25,11,25,0,0,0,0,0
2022-06-28T08:00,59.4,27,15,22,0,0,0,0,0
2022-06-28T09:00,58.7,11,6,9,0,0,0,0,0
2022-06-28T10:00,58.1,8,7,3,0,5,1,4,0
2022-06-28T11:00,59.1,7,6,2,0,94,57,37,198.4
2022-06-28T12:00,60.7,14,16,0,0,250,184,66,476.2
2022-06-28T13:00,62.7,54,60,0,0,428,337,91,629.8
2022-06-28T14:00,65,67,74,0,0,516,361,155,628.3
2022-06-28T15:00,66.7,80,89,0,0,533,239,294,420.8
2022-06-28T16:00,68.9,90,100,0,0,631,341,290,337.7
2022-06-28T17:00,70.4,100,100,42,0,649,301,348,354.9
2022-06-28T18:00,72.1,100,100,85,0,677,402,275,377.8
2022-06-28T19:00,72.5,100,63,90,0,599,257,342,358.3
2022-06-28T20:00,73.8,93,40,95,0,604,311,293,320.7
2022-06-28T21:00,74.7,67,16,88,0,562,352,210,444.2
2022-06-28T22:00,74.7,2,0,4,0,434,281,153,506
2022-06-28T23:00,73.1,0,0,0,0,325,253,72,592.8
2022-06-29T00:00,70.6,0,0,0,0,152,102,50,597.6
2022-06-29T01:00,67.9,0,0,0,0,24,12,12,193.7
2022-06-29T02:00,65.5,0,0,0,0,0,0,0,0
2022-06-29T03:00,63.5,0,0,0,0,0,0,0,0
2022-06-29T04:00,61.9,0,0,0,0,0,0,0,0
2022-06-29T05:00,60.5,2,0,0,5,0,0,0,0
2022-06-29T06:00,59.7,14,0,0,47,0,0,0,0
2022-06-29T07:00,59.9,23,0,0,78,0,0,0,0
2022-06-29T08:00,59.4,26,0,0,86,0,0,0,0
2022-06-29T09:00,59.1,27,0,0,89,0,0,0,0
2022-06-29T10:00,58.9,7,0,0,24,5,1,4,0
2022-06-29T11:00,60.8,13,0,0,44,98,58,40,200.6
2022-06-29T12:00,65.9,16,0,0,53,271,208,63,520.5
2022-06-29T13:00,70.2,23,0,0,78,446,346,100,676.5
2022-06-29T14:00,73.6,30,0,0,99,596,432,164,683.6
2022-06-29T15:00,75.9,27,0,0,91,700,435,265,608.6
2022-06-29T16:00,77.8,29,0,1,96,765,439,326,519.3
2022-06-29T17:00,79.4,68,1,61,100,824,546,278,543
2022-06-29T18:00,80.6,90,0,100,100,770,475,295,570.8
2022-06-29T19:00,76.8,75,0,80,91,289,10,279,251.3
2022-06-29T20:00,75,49,0,68,28,418,164,254,74.7
2022-06-29T21:00,74.9,23,0,36,5,503,288,215,304.2
2022-06-29T22:00,75.3,47,4,56,31,439,331,108,523.1
2022-06-29T23:00,74.1,38,12,39,13,232,146,86,504.3
2022-06-30T00:00,72.7,23,5,26,10,102,66,36,348.7
2022-06-30T01:00,70.2,31,18,24,0,20,9,11,128.4
2022-06-30T02:00,67.9,17,14,8,0,0,0,0,0
2022-06-30T03:00,66.6,15,12,7,0,0,0,0,0
2022-06-30T04:00,65,13,8,10,0,0,0,0,0
2022-06-30T05:00,62.6,35,12,7,65,0,0,0,0
2022-06-30T06:00,63.1,17,12,8,4,0,0,0,0
2022-06-30T07:00,60.4,15,15,2,1,0,0,0,0
2022-06-30T08:00,60,9,9,1,1,0,0,0,0
2022-06-30T09:00,61,11,11,1,0,0,0,0,0
2022-06-30T10:00,61.2,13,2,0,37,5,1,4,0
2022-06-30T11:00,62.7,23,3,0,68,93,57,36,206
2022-06-30T12:00,67.5,14,0,2,43,239,161,78,447
2022-06-30T13:00,71.1,29,2,0,92,407,299,108,548.4
2022-06-30T14:00,73.9,49,16,8,100,577,443,134,637.7
2022-06-30T15:00,76.7,17,12,3,16,751,628,123,746.2
2022-06-30T16:00,78.4,19,12,2,24,768,601,167,747.1
2022-06-30T17:00,80.6,92,61,48,26,816,673,143,708.6
2022-06-30T18:00,81.7,87,36,54,74,697,444,253,599.2
2022-06-30T19:00,83.4,54,21,31,56,693,474,219,481.6
2022-06-30T20:00,85.2,10,0,8,16,736,575,161,619.8
2022-06-30T21:00,85.3,22,0,28,17,552,416,136,662
2022-06-30T22:00,84.5,21,0,14,42,394,260,134,534.5
2022-06-30T23:00,81.9,18,0,11,39,239,142,97,417.8
2022-07-01T00:00,79.2,21,0,30,9,135,78,57,377.6
2022-07-01T01:00,76.4,45,0,50,51,22,11,11,153.5
2022-07-01T02:00,75,27,0,6,79,0,0,0,0
2022-07-01T03:00,73.5,28,0,2,90,0,0,0,0
2022-07-01T04:00,72,15,0,2,45,0,0,0,0
2022-07-01T05:00,70.9,25,0,1,80,0,0,0,0
2022-07-01T06:00,70.2,20,0,0,68,0,0,0,0
2022-07-01T07:00,70,13,0,0,43,0,0,0,0
2022-07-01T08:00,69.3,14,0,0,47,0,0,0,0
2022-07-01T09:00,68.7,7,0,0,24,0,0,0,0
2022-07-01T10:00,68.3,19,0,0,63,5,1,4,0
2022-07-01T11:00,69.4,29,0,0,96,93,52,41,197.5
2022-07-01T12:00,72.9,28,0,0,92,220,103,117,343.6
2022-07-01T13:00,76.6,9,0,1,27,378,203,175,348.9
2022-07-01T14:00,80.8,9,0,6,18,589,459,130,553
2022-07-01T15:00,84.7,32,1,20,65,751,629,122,766.9
2022-07-01T16:00,87.2,44,1,50,43,805,653,152,783.7
2022-07-01T17:00,87.4,35,1,46,20,734,570,164,676.5
2022-07-01T18:00,88.2,47,6,42,55,763,583,180,614.5
2022-07-01T19:00,86.9,40,2,34,59,679,489,190,576
2022-07-01T20:00,88.2,31,0,26,51,722,589,133,632.7
2022-07-01T21:00,89.5,45,0,25,99,548,405,143,662.9
2022-07-01T22:00,88.6,66,0,87,46,385,256,129,527.2
2022-07-01T23:00,85.8,11,0,16,6,221,88,133,353.8
2022-07-02T00:00,82.6,89,0,99,100,77,5,72,120.6
2022-07-02T01:00,79.2,90,0,100,100,10,0,10,3.5
2022-07-02T02:00,78.3,90,0,100,100,0,0,0,0
2022-07-02T03:00,76.1,88,0,97,100,0,0,0,0
2022-07-02T04:00,74.6,88,0,97,100,0,0,0,0
2022-07-02T05:00,73.8,90,1,99,100,0,0,0,0
2022-07-02T06:00,72.7,100,16,97,98,0,0,0,0
2022-07-02T07:00,69.4,100,84,97,94,0,0,0,0
2022-07-02T08:00,68.7,100,100,85,90,0,0,0,0
2022-07-02T09:00,68.3,100,100,96,100,0,0,0,0
2022-07-02T10:00,68.2,100,52,97,84,1,0,1,0
2022-07-02T11:00,67.9,61,20,60,22,26,5,21,10.1
2022-07-02T12:00,66.8,37,21,28,4,116,60,56,98.2
2022-07-02T13:00,67.4,45,32,27,1,352,233,119,320.4
2022-07-02T14:00,70.3,27,19,17,0,605,489,116,614
2022-07-02T15:00,73.4,10,7,6,0,792,694,98,826.5
2022-07-02T16:00,76.4,4,2,3,0,924,834,90,924.9
2022-07-02T17:00,78.6,5,2,2,5,974,870,104,945.8
2022-07-02T18:00,80.2,8,2,1,17,982,878,104,938.5
2022-07-02T19:00,81.5,18,2,2,49,886,767,119,897.5
2022-07-02T20:00,81.9,21,0,0,71,796,648,148,817.8
2022-07-02T21:00,81.9,7,0,2,20,677,576,101,807.3
2022-07-02T22:00,81,8,0,1,26,516,426,90,807.2
2022-07-02T23:00,79,4,0,3,6,322,240,82,706.7
2022-07-03T00:00,76.8,13,0,7,28,151,103,48,573.1
2022-07-03T01:00,73.1,23,0,14,48,22,10,12,190.1
2022-07-03T02:00,72.9,18,0,19,23,0,0,0,0
2022-07-03T03:00,68.8,28,2,12,62,0,0,0,0
2022-07-03T04:00,68.6,34,5,13,71,0,0,0,0
2022-07-03T05:00,66.9,42,7,13,93,0,0,0,0
2022-07-03T06:00,65.3,42,8,11,94,0,0,0,0
2022-07-03T07:00,65.6,32,2,2,97,0,0,0,0
2022-07-03T08:00,65.4,35,0,10,98,0,0,0,0
2022-07-03T09:00,64.8,60,0,50,100,0,0,0,0
2022-07-03T10:00,64.1,20,0,10,47,4,1,3,0
2022-07-03T11:00,64.6,23,0,23,30,93,57,36,207.2
2022-07-03T12:00,66.6,1,0,1,2,264,204,60,520.9
2022-07-03T13:00,68.4,0,0,0,0,450,373,77,700.6
2022-07-03T14:00,70.5,0,0,0,0,629,540,89,794.7
2022-07-03T15:00,72.7,0,0,0,0,782,685,97,854.7
2022-07-03T16:00,74.7,2,2,0,0,896,794,102,892.3
2022-07-03T17:00,76.3,7,8,0,0,963,858,105,915.2
2022-07-03T18:00,77.5,4,4,0,0,975,870,105,926.4
2022-07-03T19:00,77.8,3,3,0,0,930,827,103,924.5
2022-07-03T20:00,78,0,0,0,0,835,738,97,912.2
2022-07-03T21:00,77.7,0,0,0,0,695,602,93,883.6
2022-07-03T22:00,76.8,0,0,0,0,526,445,81,838.2
2022-07-03T23:00,75,0,0,0,0,340,272,68,767.4
2022-07-04T00:00,72,0,0,0,0,156,110,46,635.1
2022-07-04T01:00,69,0,0,0,0,24,12,12,205.1
2022-07-04T02:00,68,0,0,0,0,0,0,0,0
2022-07-04T03:00,68.4,0,0,0,0,0,0,0,0
2022-07-04T04:00,64.5,1,0,0,4,0,0,0,0
2022-07-04T05:00,63,14,0,0,47,0,0,0,0
2022-07-04T06:00,61.7,4,0,0,12,0,0,0,0
2022-07-04T07:00,62.7,2,0,0,7,0,0,0,0
2022-07-04T08:00,64.8,0,0,0,0,0,0,0,0
2022-07-04T09:00,64.1,0,0,0,1,0,0,0,0
2022-07-04T10:00,63.6,0,0,0,0,4,1,3,0
2022-07-04T11:00,61.4,0,0,0,1,93,58,35,215.1
2022-07-04T12:00,67.3,0,0,0,0,260,198,62,518.7
2022-07-04T13:00,70.4,4,0,7,0,444,366,78,685.2
2022-07-04T14:00,73.2,2,0,4,0,619,530,89,781.8
2022-07-04T15:00,75.9,0,0,0,0,767,670,97,838.7
2022-07-04T16:00,78,12,10,5,0,877,774,103,872.4
2022-07-04T17:00,79.9,47,8,66,0,938,829,109,888.6
2022-07-04T18:00,81.2,60,5,93,0,952,846,106,916.5
2022-07-04T19:00,80.9,63,6,96,0,636,406,230,685
2022-07-04T20:00,81.3,46,0,75,4,578,297,281,377.8
2022-07-04T21:00,82.1,29,0,38,21,598,448,150,498.3
2022-07-04T22:00,81.6,23,0,34,7,429,325,104,631.9
2022-07-04T23:00,80.1,59,0,79,38,277,193,84,551.7
2022-07-05T00:00,77.6,89,1,99,96,129,84,45,470.9
2022-07-05T01:00,73.8,90,0,100,99,16,3,13,144.5
2022-07-05T02:00,71.7,89,0,100,95,0,0,0,0
2022-07-05T03:00,70.3,68,0,68,92,0,0,0,0
2022-07-05T04:00,69,72,0,71,99,0,0,0,0
2022-07-05T05:00,68.7,80,0,84,98,0,0,0,0
2022-07-05T06:00,68.4,41,0,28,81,0,0,0,0
2022-07-05T07:00,68.1,40,0,51,30,0,0,0,0
2022-07-05T08:00,67.8,80,0,98,71,0,0,0,0
2022-07-05T09:00,68.1,87,0,95,100,0,0,0,0
2022-07-05T10:00,68.4,89,0,98,100,2,0,2,0
2022-07-05T11:00,70,85,0,92,100,46,6,40,19.6
2022-07-05T12:00,71.7,38,0,13,100,133,20,113,55.3
2022-07-05T13:00,73.9,35,0,9,100,176,17,159,51.2
2022-07-05T14:00,74.1,78,0,80,100,186,1,185,17.3
2022-07-05T15:00,71.6,94,5,99,100,137,0,137,0.1
2022-07-05T16:00,67.3,89,0,99,100,155,0,155,0
2022-07-05T17:00,66.8,83,0,96,84,174,0,174,0
2022-07-05T18:00,67.5,83,3,91,84,259,26,233,8.9
2022-07-05T19:00,74.7,98,10,99,99,351,127,224,87.7
2022-07-05T20:00,75.7,100,38,76,99,240,58,182,107.6
2022-07-05T21:00,78.3,100,67,62,100,301,114,187,113.4
2022-07-05T22:00,77.1,86,31,49,95,218,88,130,162.3
2022-07-05T23:00,76.1,85,36,53,68,187,92,95,203.5
2022-07-06T00:00,74.9,50,32,34,1,83,34,49,212.8
2022-07-06T01:00,73,46,18,50,0,12,3,9,60.6
2022-07-06T02:00,72,83,68,37,0,0,0,0,0
2022-07-06T03:00,71.5,100,95,45,0,0,0,0,0
2022-07-06T04:00,71.4,100,99,41,0,0,0,0,0
2022-07-06T05:00,69.9,100,100,38,22,0,0,0,0
2022-07-06T06:00,70.4,95,100,5,6,0,0,0,0
2022-07-06T07:00,69.6,100,100,0,68,0,0,0,0
2022-07-06T08:00,69.1,100,100,0,52,0,0,0,0
2022-07-06T09:00,68.5,100,100,0,86,0,0,0,0
2022-07-06T10:00,68,100,100,0,83,1,0,1,0
2022-07-06T11:00,67.7,100,100,3,46,17,1,16,3
2022-07-06T12:00,67.6,100,98,28,8,63,2,61,5.7
2022-07-06T13:00,68.1,100,100,44,96,115,22,93,16.4
2022-07-06T14:00,69.1,100,100,30,99,348,166,182,150.9
2022-07-06T15:00,70.5,100,100,29,57,431,192,239,258.3
2022-07-06T16:00,72.3,100,100,21,15,556,262,294,269.8
2022-07-06T17:00,73.8,98,99,14,0,658,334,324,326.8
2022-07-06T18:00,75.3,100,97,25,6,735,445,290,431
2022-07-06T19:00,71.9,100,93,34,0,386,173,213,334.6
2022-07-06T20:00,73.8,97,99,13,0,507,287,220,255.1
2022-07-06T21:00,74.3,91,99,3,0,475,308,167,398.3
2022-07-06T22:00,74.3,31,34,0,0,417,293,124,490.2
2022-07-06T23:00,73.4,23,25,0,0,288,209,79,549.9
2022-07-07T00:00,71.4,13,14,0,0,142,93,49,516.5
2022-07-07T01:00,69.5,9,7,0,8,21,10,11,171.1
2022-07-07T02:00,67.9,13,6,4,18,0,0,0,0
2022-07-07T03:00,66.6,4,3,0,3,0,0,0,0
2022-07-07T04:00,65.7,2,1,2,0,0,0,0,0
2022-07-07T05:00,64.7,6,3,3,6,0,0,0,0
2022-07-07T06:00,63.5,4,2,4,0,0,0,0,0
2022-07-07T07:00,61.7,13,8,9,0,0,0,0,0
2022-07-07T08:00,62.7,10,7,6,0,0,0,0,0
2022-07-07T09:00,62.1,16,13,6,1,0,0,0,0
2022-07-07T10:00,61.2,20,17,7,2,3,1,2,0
2022-07-07T11:00,62.7,7,7,1,0,83,49,34,195.6
2022-07-07T12:00,67.3,8,8,2,0,227,160,67,434.3
2022-07-07T13:00,70.7,9,9,2,0,414,334,80,598.5
2022-07-07T14:00,73.8,13,14,1,0,589,469,120,708.2
2022-07-07T15:00,76.5,19,20,1,0,743,629,114,777
2022-07-07T16:00,77.5,75,66,26,0,723,530,193,726.1
2022-07-07T17:00,78.3,91,44,86,0,571,277,294,451
2022-07-07T18:00,79.3,82,36,82,0,570,191,379,234.4
2022-07-07T19:00,80.4,86,35,91,0,653,291,362,262.8
2022-07-07T20:00,80.8,67,2,99,20,525,193,332,286.2
2022-07-07T21:00,80.3,83,23,91,26,442,163,279,221.6
2022-07-07T22:00,79.3,43,0,29,84,373,256,117,343.3
2022-07-07T23:00,78.8,43,2,27,83,306,224,82,544.3
2022-07-08T00:00,76.9,46,6,23,90,141,87,54,527.4
2022-07-08T01:00,76.1,49,17,16,81,21,9,12,156.3
2022-07-08T02:00,71.7,42,16,7,79,0,0,0,0
2022-07-08T03:00,69.5,32,12,6,58,0,0,0,0
2022-07-08T04:00,67.6,47,20,22,51,0,0,0,0
2022-07-08T05:00,68.7,39,10,14,72,0,0,0,0
2022-07-08T06:00,69.2,28,14,10,30,0,0,0,0
2022-07-08T07:00,69.3,7,5,3,2,0,0,0,0
2022-07-08T08:00,68.6,9,3,3,14,0,0,0,0
2022-07-08T09:00,66.6,29,2,3,83,0,0,0,0
2022-07-08T10:00,64.8,28,0,0,94,3,0,3,0
2022-07-08T11:00,66.7,30,7,0,79,77,33,44,108.2
2022-07-08T12:00,70.9,37,11,2,86,229,149,80,363.7
2022-07-08T13:00,73.1,38,6,7,94,393,260,133,511.4
2022-07-08T14:00,75.4,30,1,5,87,551,376,175,561.9
2022-07-08T15:00,77.2,18,6,18,6,651,424,227,569.8
2022-07-08T16:00,79,39,11,38,22,688,418,270,511
2022-07-08T17:00,80,26,6,24,21,728,461,267,495.5
2022-07-08T18:00,79.9,50,21,23,57,571,239,332,366
2022-07-08T19:00,81.3,56,1,45,94,720,517,203,411.3
2022-07-08T20:00,81.2,67,0,61,100,573,311,262,502.8
2022-07-08T21:00,80.1,64,0,57,100,359,112,247,265
2022-07-08T22:00,79.2,66,4,54,100,293,83,210,149.3
2022-07-08T23:00,77.4,68,5,57,98,195,37,158,127.2
2022-07-09T00:00,74.7,44,4,27,81,76,8,68,66.8
2022-07-09T01:00,72.5,26,2,14,53,13,2,11,15.3
2022-07-09T02:00,70.9,21,8,16,13,0,0,0,0
2022-07-09T03:00,69,29,16,23,2,0,0,0,0
2022-07-09T04:00,68.2,40,19,28,20,0,0,0,0
2022-07-09T05:00,66.7,59,23,29,68,0,0,0,0
2022-07-09T06:00,66.4,62,37,38,19,0,0,0,0
2022-07-09T07:00,65.7,52,30,35,14,0,0,0,0
2022-07-09T08:00,64.9,31,23,17,1,0,0,0,0
2022-07-09T09:00,63.9,16,16,2,0,0,0,0,0
2022-07-09T10:00,62.8,7,8,0,0,3,1,2,0
2022-07-09T11:00,63.4,10,11,0,0,85,51,34,206.8
2022-07-09T12:00,65.6,4,4,0,0,254,192,62,501.4
2022-07-09T13:00,68.4,0,0,0,0,442,363,79,686.1
2022-07-09T14:00,71.3,0,0,0,0,627,539,88,795.3
2022-07-09T15:00,73.5,2,2,0,0,781,684,97,862.1
2022-07-09T16:00,75.1,4,4,0,0,897,797,100,899.6
2022-07-09T17:00,76.3,0,0,0,0,964,861,103,923.6
2022-07-09T18:00,77.1,0,0,0,0,974,870,104,931.7
2022-07-09T19:00,77.5,0,0,0,0,930,828,102,928.3
2022-07-09T20:00,77.4,0,0,0,0,836,739,97,916.1
2022-07-09T21:00,76.5,0,0,0,0,698,608,90,891.6
2022-07-09T22:00,75,0,0,0,0,527,447,80,848.5
2022-07-09T23:00,72.9,0,0,0,0,339,273,66,776.2
2022-07-10T00:00,69.9,0,0,0,0,155,108,47,640
2022-07-10T01:00,66.4,0,0,0,0,22,12,10,193.2
2022-07-10T02:00,64.2,0,0,0,0,0,0,0,0
2022-07-10T03:00,62.8,0,0,0,0,0,0,0,0
2022-07-10T04:00,61.8,0,0,0,0,0,0,0,0
2022-07-10T05:00,60.9,0,0,0,0,0,0,0,0
2022-07-10T06:00,59.9,0,0,0,0,0,0,0,0
2022-07-10T07:00,57.6,0,0,0,0,0,0,0,0
2022-07-10T08:00,56.7,0,0,0,0,0,0,0,0
2022-07-10T09:00,55.8,0,0,0,0,0,0,0,0
2022-07-10T10:00,55.4,0,0,0,0,3,1,2,0
2022-07-10T11:00,57.4,0,0,0,0,87,55,32,226.7
2022-07-10T12:00,63.1,1,0,0,3,256,196,60,529.3
2022-07-10T13:00,67.2,5,0,0,17,443,367,76,700.6
2022-07-10T14:00,70.4,3,0,0,9,618,522,96,789.2
2022-07-10T15:00,73.4,11,0,0,38,767,648,119,827
2022-07-10T16:00,75.9,2,0,1,4,875,733,142,841.1
2022-07-10T17:00,77.9,9,5,8,0,936,774,162,837.4
2022-07-10T18:00,79.6,0,0,0,0,960,840,120,866.8
2022-07-10T19:00,79.8,0,0,0,0,927,830,97,916.8
2022-07-10T20:00,80.3,0,0,0,0,829,732,97,915.3
2022-07-10T21:00,80.3,0,0,0,0,689,601,88,883
2022-07-10T22:00,79.7,4,0,0,12,517,438,79,837
2022-07-10T23:00,78.3,2,0,0,5,329,261,68,753.6
2022-07-11T00:00,74.8,1,0,0,2,148,101,47,609.4
2022-07-11T01:00,71.4,0,0,0,0,21,10,11,176.6
2022-07-11T02:00,71.5,0,0,0,0,0,0,0,0
2022-07-11T03:00,67.1,0,0,0,0,0,0,0,0
2022-07-11T04:00,66.3,0,0,0,0,0,0,0,0
2022-07-11T05:00,64.9,0,0,0,0,0,0,0,0
2022-07-11T06:00,63.8,0,0,0,0,0,0,0,0
2022-07-11T07:00,64,2,0,0,7,0,0,0,0
2022-07-11T08:00,63.3,23,0,0,76,0,0,0,0
2022-07-11T09:00,62.8,1,0,0,3,0,0,0,0
2022-07-11T10:00,62.1,0,0,0,0,2,1,1,0
2022-07-11T11:00,63.5,2,1,1,0,84,53,31,224.6
2022-07-11T12:00,68.7,2,2,0,0,249,192,57,520.5
2022-07-11T13:00,73.8,7,5,2,5,430,351,79,679.3
2022-07-11T14:00,77.8,9,3,4,13,607,522,85,773
2022-07-11T15:00,81.6,1,0,1,0,757,663,94,838.4
2022-07-11T16:00,84.4,5,6,0,0,869,774,95,877
2022-07-11T17:00,86.1,8,7,2,0,924,797,127,879.8
2022-07-11T18:00,87.3,3,0,5,0,898,772,126,841.7
2022-07-11T19:00,89,1,0,1,0,907,800,107,861.2
2022-07-11T20:00,89.6,7,0,11,0,785,680,105,869.3
2022-07-11T21:00,89.8,5,0,8,0,654,555,99,819.1
2022-07-11T22:00,89.1,23,0,19,37,479,384,95,754.4
2022-07-11T23:00,87.3,47,0,56,46,313,234,79,670.5
2022-07-12T00:00,83.6,40,0,52,29,124,75,49,508.7
2022-07-12T01:00,80.1,19,0,6,50,17,7,10,127.2
2022-07-12T02:00,78.4,37,0,19,86,0,0,0,0
2022-07-12T03:00,77.4,85,0,99,86,0,0,0,0
2022-07-12T04:00,76.3,88,4,93,95,0,0,0,0
2022-07-12T05:00,75.9,87,2,92,100,0,0,0,0
2022-07-12T06:00,76,93,3,100,100,0,0,0,0
2022-07-12T07:00,75.2,100,21,91,99,0,0,0,0
2022-07-12T08:00,74.8,57,17,20,100,0,0,0,0
2022-07-12T09:00,74,68,4,58,98,0,0,0,0
2022-07-12T10:00,73.5,39,10,14,72,1,0,1,0
2022-07-12T11:00,73.8,42,10,21,68,40,3,37,6.9
2022-07-12T12:00,75.6,35,14,30,16,113,36,77,69.2
2022-07-12T13:00,77.2,30,20,19,1,174,71,103,128.9
2022-07-12T14:00,78.3,20,16,9,0,334,205,129,222.8
2022-07-12T15:00,80.5,45,30,30,0,579,454,125,455.4
2022-07-12T16:00,82.9,38,11,45,3,743,599,144,650.1
2022-07-12T17:00,84.6,31,8,40,0,775,625,150,690
2022-07-12T18:00,85,19,0,31,0,720,586,134,654.4
2022-07-12T19:00,86.5,15,2,22,1,683,533,150,613.5
2022-07-12T20:00,85.3,10,2,14,0,584,427,157,556.7
2022-07-12T21:00,85.5,14,4,14,7,510,414,96,554.3
2022-07-12T22:00,84.8,16,0,27,0,441,364,77,642.9
2022-07-12T23:00,82.7,22,2,33,0,256,181,75,587.6
2022-07-13T00:00,79.2,20,1,31,1,101,62,39,401.1
2022-07-13T01:00,76,22,0,32,9,14,5,9,102.7
2022-07-13T02:00,73.7,27,1,43,0,0,0,0,0
2022-07-13T03:00,72,27,1,43,1,0,0,0,0
2022-07-13T04:00,70.7,27,1,43,0,0,0,0,0
2022-07-13T05:00,69.7,27,1,43,0,0,0,0,0
2022-07-13T06:00,68.7,20,0,33,0,0,0,0,0
2022-07-13T07:00,67.5,17,0,29,0,0,0,0,0
2022-07-13T08:00,66.7,24,8,28,0,0,0,0,0
2022-07-13T09:00,65.7,12,8,8,0,0,0,0,0
2022-07-13T10:00,64.5,48,10,65,0,2,0,2,0
2022-07-13T11:00,66.5,61,20,71,0,74,43,31,157.4
2022-07-13T12:00,70.1,100,70,71,0,222,159,63,437.7
2022-07-13T13:00,72.8,92,54,72,0,393,302,91,585.9
2022-07-13T14:00,74.4,56,28,52,0,480,353,127,595.8
2022-07-13T15:00,75.3,64,42,43,0,573,448,125,561.9
2022-07-13T16:00,77,46,27,36,0,721,550,171,604.9
2022-07-13T17:00,79.1,49,27,41,0,812,671,141,690.1
2022-07-13T18:00,79.2,60,28,58,0,655,508,147,646.4
2022-07-13T19:00,80.8,46,22,38,12,563,397,166,481.5
2022-07-13T20:00,82.8,43,9,36,43,619,491,128,525.4
2022-07-13T21:00,81.6,57,26,30,51,435,308,127,541.7
2022-07-13T22:00,75.9,34,8,39,11,270,120,150,325.1
2022-07-13T23:00,71.6,34,6,45,5,186,109,77,250.4
2022-07-14T00:00,69.9,32,5,26,38,83,38,45,251.9
2022-07-14T01:00,68.8,34,8,33,24,12,3,9,62.2
2022-07-14T02:00,67.8,37,3,55,3,0,0,0,0
2022-07-14T03:00,66.7,72,19,83,18,0,0,0,0
2022-07-14T04:00,66.1,57,10,66,27,0,0,0,0
2022-07-14T05:00,65.5,54,11,61,25,0,0,0,0
2022-07-14T06:00,65,68,29,61,17,0,0,0,0
2022-07-14T07:00,65.4,56,23,56,5,0,0,0,0
2022-07-14T08:00,65,56,25,55,0,0,0,0,0
2022-07-14T09:00,64.6,42,22,36,1,0,0,0,0
2022-07-14T10:00,64.2,39,23,30,0,1,0,1,0
2022-07-14T11:00,64.7,45,29,32,0,49,23,26,83.9
2022-07-14T12:00,65.8,34,21,25,0,166,93,73,246.7
2022-07-14T13:00,67.4,42,26,31,0,302,207,95,370.4
2022-07-14T14:00,69.3,37,24,25,0,446,333,113,488.4
2022-07-14T15:00,71.1,71,31,71,0,498,302,196,459.5
2022-07-14T16:00,73.5,38,22,30,0,616,410,206,422.6
2022-07-14T17:00,75.4,25,16,18,0,739,535,204,531
2022-07-14T18:00,75.8,31,15,29,0,700,513,187,564.5
2022-07-14T19:00,76.9,35,14,38,0,760,632,128,626.6
2022-07-14T20:00,77.2,19,1,30,0,711,587,124,723.4
2022-07-14T21:00,76.7,19,2,29,0,587,477,110,711.6
2022-07-14T22:00,75.6,12,2,17,0,410,316,94,637.5
2022-07-14T23:00,74.6,10,1,15,0,276,199,77,556.9
2022-07-15T00:00,72.5,4,0,6,0,131,92,39,515.4
2022-07-15T01:00,70.3,3,0,5,0,15,7,8,152.2
2022-07-15T02:00,68.4,2,0,3,0,0,0,0,0
2022-07-15T03:00,66.6,1,0,1,0,0,0,0,0
2022-07-15T04:00,67.9,1,0,1,0,0,0,0,0
2022-07-15T05:00,67.5,1,0,1,0,0,0,0,0
2022-07-15T06:00,66.5,1,0,1,0,0,0,0,0
2022-07-15T07:00,64.6,1,0,1,0,0,0,0,0
2022-07-15T08:00,63.9,0,0,0,0,0,0,0,0
2022-07-15T09:00,63.3,1,0,1,0,0,0,0,0
2022-07-15T10:00,63,1,0,1,0,1,0,1,0
2022-07-15T11:00,63.5,0,0,0,0,78,48,30,180.5
2022-07-15T12:00,67.6,0,0,0,0,243,184,59,509.8
2022-07-15T13:00,72.1,0,0,0,0,431,356,75,684.2
2022-07-15T14:00,74.7,0,0,0,0,610,523,87,789.8
2022-07-15T15:00,77.1,0,0,0,0,755,659,96,845.8
2022-07-15T16:00,79,10,5,9,0,814,707,107,851.1
2022-07-15T17:00,80.3,16,0,26,0,751,507,244,686.6
2022-07-15T18:00,81,20,0,33,0,718,477,241,521.8
2022-07-15T19:00,82.2,22,0,37,0,715,453,262,507.3
2022-07-15T20:00,82.7,27,0,45,1,693,448,245,529.1
2022-07-15T21:00,82.6,5,0,7,4,564,392,172,561.8
2022-07-15T22:00,81.9,29,0,2,94,445,306,139,560.5
2022-07-15T23:00,80.5,26,0,1,83,330,268,62,651.4
2022-07-16T00:00,77.4,30,0,0,99,144,98,46,639.3
2022-07-16T01:00,74.1,30,0,0,100,17,6,11,154.8
2022-07-16T02:00,71.5,30,0,0,100,0,0,0,0
2022-07-16T03:00,69.2,30,0,0,100,0,0,0,0
2022-07-16T04:00,67.4,30,0,0,99,0,0,0,0
2022-07-16T05:00,66.5,30,0,0,100,0,0,0,0
2022-07-16T06:00,65.7,30,0,0,100,0,0,0,0
2022-07-16T07:00,66.6,30,0,0,100,0,0,0,0
2022-07-16T08:00,66.2,30,0,0,100,0,0,0,0
2022-07-16T09:00,66,30,0,0,100,0,0,0,0
2022-07-16T10:00,65.7,34,0,6,100,1,0,1,0
2022-07-16T11:00,66.2,49,0,32,100,38,1,37,2.5
2022-07-16T12:00,69.1,59,0,48,100,133,9,124,10.2
2022-07-16T13:00,74.7,50,0,34,97,313,120,193,138.2
2022-07-16T14:00,78.3,28,0,6,81,456,199,257,291.5
2022-07-16T15:00,81.5,23,0,0,75,590,260,330,329.2
2022-07-16T16:00,83,25,0,0,82,696,293,403,338.2
2022-07-16T17:00,83.9,26,0,2,82,708,360,348,360.4
2022-07-16T18:00,85,18,0,2,55,757,471,286,447
2022-07-16T19:00,86.9,24,0,17,45,771,538,233,559.3
2022-07-16T20:00,87.7,27,0,32,27,701,499,202,615.2
2022-07-16T21:00,88,17,0,23,10,580,408,172,610.3
2022-07-16T22:00,87.3,0,0,0,0,397,246,151,527.6
2022-07-16T23:00,85.1,1,0,2,0,249,135,114,399.9
2022-07-17T00:00,81.5,0,0,0,0,139,96,43,441.9
2022-07-17T01:00,76.2,1,0,1,0,17,8,9,157.9
2022-07-17T02:00,76.6,1,0,2,0,0,0,0,0
2022-07-17T03:00,74.7,2,0,3,0,0,0,0,0
2022-07-17T04:00,70.2,1,0,1,2,0,0,0,0
2022-07-17T05:00,69.9,1,0,2,0,0,0,0,0
2022-07-17T06:00,69.1,1,0,2,0,0,0,0,0
2022-07-17T07:00,68.3,1,0,2,0,0,0,0,0
2022-07-17T08:00,67.6,1,0,2,0,0,0,0,0
2022-07-17T09:00,67.2,1,0,1,2,0,0,0,0
2022-07-17T10:00,66.7,14,0,10,27,1,0,1,0
2022-07-17T11:00,67.4,27,0,8,75,71,41,30,158.3
2022-07-17T12:00,72.1,19,0,0,64,231,170,61,466
2022-07-17T13:00,76.5,2,0,0,7,414,339,75,650.2
2022-07-17T14:00,80.7,14,0,0,48,593,502,91,759.8
2022-07-17T15:00,84.2,26,0,1,83,744,647,97,824.7
2022-07-17T16:00,86.5,30,0,1,99,833,701,132,832.3
2022-07-17T17:00,88.7,31,0,2,100,903,742,161,820.4
2022-07-17T18:00,89.4,59,0,50,96,785,508,277,689.6
2022-07-17T19:00,89.4,69,0,66,99,610,291,319,433.7
2022-07-17T20:00,88.4,60,0,50,100,386,165,221,257.2
2022-07-17T21:00,88.2,52,0,36,100,395,144,251,205.6
2022-07-17T22:00,85.8,52,0,36,100,220,59,161,163.2
2022-07-17T23:00,82.1,62,8,41,100,115,16,99,73.7
2022-07-18T00:00,79.5,56,4,37,100,57,5,52,33.3
2022-07-18T01:00,77.2,58,6,37,100,8,0,8,6.9
2022-07-18T02:00,76,47,3,23,100,0,0,0,0
2022-07-18T03:00,75.2,50,5,26,100,0,0,0,0
2022-07-18T04:00,74.8,56,0,43,100,0,0,0,0
2022-07-18T05:00,74.4,80,0,83,100,0,0,0,0
2022-07-18T06:00,74,89,0,98,100,0,0,0,0
2022-07-18T07:00,72,90,0,100,100,0,0,0,0
2022-07-18T08:00,70.1,89,0,98,100,0,0,0,0
2022-07-18T09:00,69.8,90,0,100,100,0,0,0,0
2022-07-18T10:00,69.6,91,1,100,100,0,0,0,0
2022-07-18T11:00,69.7,88,0,97,100,7,0,7,0
2022-07-18T12:00,70,100,28,100,100,25,0,25,0
2022-07-18T13:00,70.4,100,24,100,100,40,0,40,0
2022-07-18T14:00,70.9,100,49,100,100,54,1,53,0.8
2022-07-18T15:00,71.6,100,49,100,100,86,0,86,0.6
2022-07-18T16:00,72.6,100,42,98,100,143,6,137,3.6
2022-07-18T17:00,73.1,100,33,95,98,111,0,111,2.6
2022-07-18T18:00,73.5,94,8,96,98,167,32,135,16
2022-07-18T19:00,75.5,100,22,86,100,243,44,199,42.4
2022-07-18T20:00,77.1,100,21,95,100,247,58,189,61.9
2022-07-18T21:00,74.6,100,39,58,100,168,36,132,63.2
2022-07-18T22:00,73.8,91,18,74,100,159,29,130,53.1
2022-07-18T23:00,73,70,8,59,92,97,13,84,45.1
2022-07-19T00:00,72.4,100,46,94,14,62,6,56,33.3
2022-07-19T01:00,71.9,100,91,94,0,7,1,6,9.9
2022-07-19T02:00,71.1,100,72,58,0,0,0,0,0
2022-07-19T03:00,70.6,74,62,31,0,0,0,0,0
2022-07-19T04:00,70.4,49,40,22,0,0,0,0,0
2022-07-19T05:00,70.2,22,19,8,0,0,0,0,0
2022-07-19T06:00,69.8,1,1,0,0,0,0,0,0
2022-07-19T07:00,69.5,0,0,0,0,0,0,0,0
2022-07-19T08:00,69.1,0,0,0,0,0,0,0,0
2022-07-19T09:00,68.5,0,0,0,0,0,0,0,0
2022-07-19T10:00,68,0,0,0,0,1,0,1,0
2022-07-19T11:00,68.4,0,0,0,0,70,43,27,0
2022-07-19T12:00,70.8,4,4,0,0,231,174,57,478.6
2022-07-19T13:00,74.4,4,4,0,0,414,340,74,665.1
2022-07-19T14:00,78.4,2,0,1,6,585,499,86,763.3
2022-07-19T15:00,82,18,7,13,13,733,638,95,817.2
2022-07-19T16:00,84.8,11,5,8,7,845,747,98,855.9
2022-07-19T17:00,86.9,29,12,7,47,887,772,115,859.2
2022-07-19T18:00,87.5,29,17,12,20,869,751,118,839.2
2022-07-19T19:00,87.5,26,12,23,4,634,462,172,661.8
2022-07-19T20:00,88.7,28,6,35,4,679,529,150,577.9
2022-07-19T21:00,87.3,35,3,50,6,511,403,108,631.7
2022-07-19T22:00,85.3,23,1,35,3,362,266,96,545.3
2022-07-19T23:00,83.3,33,0,42,25,207,132,75,426.2
2022-07-20T00:00,81.6,39,8,37,31,109,68,41,367
2022-07-20T01:00,79.9,41,8,31,51,13,6,7,103.9
2022-07-20T02:00,78.4,36,8,26,45,0,0,0,0
2022-07-20T03:00,77.2,19,2,6,45,0,0,0,0
2022-07-20T04:00,76,15,0,0,49,0,0,0,0
2022-07-20T05:00,75.3,16,0,0,53,0,0,0,0
2022-07-20T06:00,73.9,15,0,19,11,0,0,0,0
2022-07-20T07:00,72.9,39,0,57,16,0,0,0,0
2022-07-20T08:00,71.6,51,0,84,1,0,0,0,0
2022-07-20T09:00,70.6,20,0,33,0,0,0,0,0
2022-07-20T10:00,69.7,13,0,21,0,1,0,1,0
2022-07-20T11:00,71.5,10,3,12,0,64,37,27,0
2022-07-20T12:00,77.5,18,20,0,0,217,159,58,431.9
2022-07-20T13:00,81,6,7,0,0,396,321,75,622.2
2022-07-20T14:00,83.8,6,3,5,0,568,481,87,731.2
2022-07-20T15:00,86.4,5,4,2,0,718,622,96,796
2022-07-20T16:00,88.2,17,7,17,0,801,702,99,821.5
2022-07-20T17:00,90,18,9,17,0,830,723,107,808.1
2022-07-20T18:00,91,15,7,13,3,793,659,134,752.2
2022-07-20T19:00,91.8,6,2,4,5,751,627,124,704.2
2022-07-20T20:00,93,5,0,5,8,753,630,123,746.9
2022-07-20T21:00,93,4,0,3,6,608,493,115,760.2
2022-07-20T22:00,91.9,35,0,33,52,416,318,98,657.2
2022-07-20T23:00,89.9,32,0,28,50,265,207,58,583.8
2022-07-21T00:00,86.4,21,0,19,31,118,78,40,508.7
2022-07-21T01:00,83,24,0,17,45,13,6,7,112.4
2022-07-21T02:00,81.2,28,0,20,53,0,0,0,0
2022-07-21T03:00,80.5,19,0,9,46,0,0,0,0
2022-07-21T04:00,79.7,19,0,11,41,0,0,0,0
2022-07-21T05:00,78.7,34,2,11,86,0,0,0,0
2022-07-21T06:00,77.9,35,0,11,96,0,0,0,0
2022-07-21T07:00,79.2,38,4,13,90,0,0,0,0
2022-07-21T08:00,78.3,36,7,20,59,0,0,0,0
2022-07-21T09:00,77.2,19,4,19,13,0,0,0,0
2022-07-21T10:00,76.5,8,1,8,9,0,0,0,0
2022-07-21T11:00,76.4,10,4,9,3,55,30,25,0
2022-07-21T12:00,77.4,9,6,5,1,187,127,60,350.3
2022-07-21T13:00,79.4,11,4,13,0,357,272,85,514.3
2022-07-21T14:00,81.6,38,24,27,0,545,432,113,644.4
2022-07-21T15:00,83.3,29,16,24,0,625,514,111,692
2022-07-21T16:00,84.6,25,5,34,0,674,522,152,646.4
2022-07-21T17:00,85.5,24,9,27,0,661,491,170,576.5
2022-07-21T18:00,86.3,22,11,20,0,594,385,209,464
2022-07-21T19:00,87.5,16,6,18,0,743,622,121,558.1
2022-07-21T20:00,87,22,4,31,0,603,462,141,651.9
2022-07-21T21:00,86.9,20,6,25,0,510,392,118,569.7
2022-07-21T22:00,85.7,52,7,76,0,396,298,98,567.2
2022-07-21T23:00,84.2,30,6,41,0,270,199,71,563
2022-07-22T00:00,81.5,25,2,38,0,109,65,44,465
2022-07-22T01:00,79.1,21,5,27,0,12,5,7,90.4
2022-07-22T02:00,76.9,9,2,12,0,0,0,0,0
2022-07-22T03:00,75.6,7,0,11,0,0,0,0,0
2022-07-22T04:00,74.4,4,0,6,0,0,0,0,0
2022-07-22T05:00,73.3,6,0,10,0,0,0,0,0
2022-07-22T06:00,72.2,8,0,14,0,0,0,0,0
2022-07-22T07:00,71.8,4,0,7,0,0,0,0,0
2022-07-22T08:00,70.8,5,0,9,0,0,0,0,0
2022-07-22T09:00,70.4,9,0,15,0,0,0,0,0
2022-07-22T10:00,69.6,8,0,13,0,0,0,0,0
2022-07-22T11:00,70.9,7,0,10,2,60,35,25,0
2022-07-22T12:00,75.5,11,0,16,6,220,163,57,440.7
2022-07-22T13:00,79.1,14,0,22,2,407,334,73,651.9
2022-07-22T14:00,82,6,0,10,0,583,497,86,763.2
2022-07-22T15:00,85,11,2,15,0,745,653,92,840.8
2022-07-22T16:00,86.5,24,3,36,0,689,578,111,774.4
2022-07-22T17:00,87.1,32,1,44,15,717,598,119,663.9
2022-07-22T18:00,86.9,45,17,44,12,620,482,138,591.7
2022-07-22T19:00,84.5,35,19,30,0,595,429,166,501.2
2022-07-22T20:00,84.9,17,3,23,0,549,350,199,450.5
2022-07-22T21:00,86.4,20,8,21,0,565,450,115,552.4
2022-07-22T22:00,86.1,18,1,28,0,358,248,110,579.9
2022-07-22T23:00,83.3,47,10,54,20,190,123,67,398
2022-07-23T00:00,80.7,15,1,22,2,100,61,39,344.4
2022-07-23T01:00,78.3,4,0,7,0,11,5,6,84.5
2022-07-23T02:00,76.5,3,0,5,0,0,0,0,0
2022-07-23T03:00,74.8,0,0,0,0,0,0,0,0
2022-07-23T04:00,73.5,0,0,0,0,0,0,0,0
2022-07-23T05:00,72.9,0,0,0,0,0,0,0,0
2022-07-23T06:00,72.4,0,0,0,0,0,0,0,0
2022-07-23T07:00,70.7,0,0,0,0,0,0,0,0
2022-07-23T08:00,70.1,0,0,0,0,0,0,0,0
2022-07-23T09:00,69.1,0,0,0,0,0,0,0,0
2022-07-23T10:00,68.5,0,0,0,0,0,0,0,0
2022-07-23T11:00,68.9,0,0,0,0,62,37,25,0
2022-07-23T12:00,72.4,0,0,0,0,220,164,56,459.8
2022-07-23T13:00,76.3,0,0,0,0,397,324,73,644.9
2022-07-23T14:00,80.8,6,0,0,20,582,498,84,755.4
2022-07-23T15:00,85.4,5,0,0,16,733,640,93,827.3
2022-07-23T16:00,88.5,3,0,1,9,844,745,99,862.2
2022-07-23T17:00,90.9,4,0,2,8,885,785,100,871
2022-07-23T18:00,92.8,29,0,1,96,875,748,127,845.8
2022-07-23T19:00,93.6,47,0,28,100,764,553,211,728.3
2022-07-23T20:00,90.4,59,0,48,100,547,335,212,524.6
2022-07-23T21:00,86.3,44,0,23,100,384,153,231,314.1
2022-07-23T22:00,86.2,32,0,4,100,299,125,174,227.1
2022-07-23T23:00,85.4,38,0,14,100,195,45,150,183.5
2022-07-24T00:00,83.3,42,0,26,89,88,18,70,111.1
2022-07-24T01:00,80.5,12,0,19,1,9,2,7,24.5
2022-07-24T02:00,78.6,5,0,7,1,0,0,0,0
2022-07-24T03:00,77.5,11,0,7,23,0,0,0,0
2022-07-24T04:00,77.1,18,1,3,50,0,0,0,0
2022-07-24T05:00,76.4,40,0,27,80,0,0,0,0
2022-07-24T06:00,75.1,38,0,25,78,0,0,0,0
2022-07-24T07:00,74.3,13,0,2,39,0,0,0,0
2022-07-24T08:00,73.2,14,0,0,47,0,0,0,0
2022-07-24T09:00,72.3,20,0,0,66,0,0,0,0
2022-07-24T10:00,71.7,26,0,0,88,0,0,0,0
2022-07-24T11:00,72.5,30,0,0,100,54,25,29,0
2022-07-24T12:00,75.6,26,0,0,87,187,94,93,280.1
2022-07-24T13:00,79.1,14,0,1,46,367,255,112,447.2
2022-07-24T14:00,82.3,26,1,12,59,511,341,170,566.8
2022-07-24T15:00,85,27,0,11,67,613,343,270,506.3
2022-07-24T16:00,87.6,38,0,27,71,607,330,277,421.4
2022-07-24T17:00,89.6,65,0,90,38,635,272,363,349.8
2022-07-24T18:00,85.5,79,3,84,85,449,87,362,192.6
2022-07-24T19:00,90.7,56,5,41,90,382,138,244,111
2022-07-24T20:00,85.5,79,1,82,97,461,234,227,231.7
2022-07-24T21:00,84.3,84,0,95,89,294,109,185,236.5
2022-07-24T22:00,83.2,47,0,47,61,201,48,153,119.2
2022-07-24T23:00,81.5,32,0,12,82,149,47,102,108.2
2022-07-25T00:00,80.4,33,0,15,81,73,23,50,136.5
2022-07-25T01:00,78.8,35,5,28,47,7,2,5,29.7
2022-07-25T02:00,77.8,35,3,13,82,0,0,0,0
2022-07-25T03:00,77.2,50,1,41,82,0,0,0,0
2022-07-25T04:00,77,60,0,50,99,0,0,0,0
2022-07-25T05:00,77.2,58,0,47,100,0,0,0,0
2022-07-25T06:00,77.4,49,1,30,100,0,0,0,0
2022-07-25T07:00,75.3,69,28,23,100,0,0,0,0
2022-07-25T08:00,75.9,100,77,72,90,0,0,0,0
2022-07-25T09:00,75.6,100,68,63,74,0,0,0,0
2022-07-25T10:00,72.6,100,32,94,61,0,0,0,0
2022-07-25T11:00,72.3,96,56,75,3,12,3,9,0
2022-07-25T12:00,72,62,36,42,13,95,39,56,79.9
2022-07-25T13:00,72.4,48,39,17,8,196,113,83,195.5
2022-07-25T14:00,72.2,32,14,27,12,297,180,117,267.2
2022-07-25T15:00,73.1,45,25,37,0,473,340,133,368.8
2022-07-25T16:00,74.7,42,29,27,0,619,459,160,494.3
2022-07-25T17:00,77.4,40,25,29,0,850,654,196,640.4
2022-07-25T18:00,78.1,50,27,41,3,712,487,225,644.5
2022-07-25T19:00,79.2,46,19,47,3,507,273,234,402.4
2022-07-25T20:00,79.9,53,31,42,1,679,485,194,443
2022-07-25T21:00,79.5,43,23,37,0,591,488,103,680.3
2022-07-25T22:00,78.4,40,22,33,0,432,326,106,679.4
2022-07-25T23:00,76.5,33,21,24,0,268,197,71,593.3
2022-07-26T00:00,74,42,33,20,0,107,66,41,480
2022-07-26T01:00,71.6,28,24,10,0,10,4,6,78
2022-07-26T02:00,69.7,20,21,1,0,0,0,0,0
2022-07-26T03:00,68.2,14,15,1,0,0,0,0,0
2022-07-26T04:00,67.1,9,10,0,0,0,0,0,0
2022-07-26T05:00,66.2,11,12,0,0,0,0,0,0
2022-07-26T06:00,65.2,10,11,0,0,0,0,0,0
2022-07-26T07:00,64.5,11,12,0,2,0,0,0,0
2022-07-26T08:00,63.7,19,11,0,29,0,0,0,0
2022-07-26T09:00,62.7,7,2,0,16,0,0,0,0
2022-07-26T10:00,61.9,14,1,0,45,0,0,0,0
2022-07-26T11:00,62.9,29,1,0,93,53,24,29,0
2022-07-26T12:00,66.6,31,1,0,100,163,56,107,218.5
2022-07-26T13:00,68.6,28,0,0,93,321,175,146,284.9
2022-07-26T14:00,70.6,9,0,0,29,493,318,175,458.8
2022-07-26T15:00,72.4,45,47,0,9,578,366,212,515
2022-07-26T16:00,73.9,94,81,2,65,571,272,299,399.1
2022-07-26T17:00,76.3,100,85,2,93,599,404,195,379.5
2022-07-26T18:00,77.1,100,62,79,79,552,316,236,406.2
2022-07-26T19:00,77.9,66,2,83,47,532,215,317,293.1
2022-07-26T20:00,77.8,66,8,97,1,449,169,280,217.7
2022-07-26T21:00,78.1,49,2,79,0,464,257,207,287.3
2022-07-26T22:00,77.9,47,5,70,0,404,282,122,469.9
2022-07-26T23:00,76.1,29,0,48,0,229,155,74,501.9
2022-07-27T00:00,73.5,12,4,14,0,107,60,47,404.7
2022-07-27T01:00,71.1,5,0,0,18,9,3,6,68.1
2022-07-27T02:00,69.3,0,0,0,0,0,0,0,0
2022-07-27T03:00,67.5,1,0,1,0,0,0,0,0
2022-07-27T04:00,66.5,2,1,2,0,0,0,0,0
2022-07-27T05:00,66,5,4,3,0,0,0,0,0
2022-07-27T06:00,65,18,14,9,0,0,0,0,0
2022-07-27T07:00,64.8,11,9,4,2,0,0,0,0
2022-07-27T08:00,64.2,21,13,7,17,0,0,0,0
2022-07-27T09:00,64.1,47,20,7,83,0,0,0,0
2022-07-27T10:00,63.9,100,69,49,31,0,0,0,0
2022-07-27T11:00,64.5,94,63,44,35,43,22,21,0
2022-07-27T12:00,68.5,72,40,12,96,173,100,73,293.8
2022-07-27T13:00,72.3,54,24,7,94,311,221,90,428.7
2022-07-27T14:00,76.1,30,15,12,30,485,337,148,523.6
2022-07-27T15:00,79.1,53,25,2,99,627,417,210,558.7
2022-07-27T16:00,81,59,28,6,100,673,410,263,532.2
2022-07-27T17:00,82.3,34,4,0,100,513,205,308,356.2
2022-07-27T18:00,83.9,42,0,20,100,517,169,348,180.1
2022-07-27T19:00,83.4,77,0,79,100,749,487,262,380.2
2022-07-27T20:00,83.1,85,0,92,98,482,163,319,400.7
2022-07-27T21:00,82.6,57,0,47,97,397,110,287,167.5
2022-07-27T22:00,82.2,42,17,25,39,329,119,210,184.1
2022-07-27T23:00,81.1,37,11,21,47,249,161,88,352.7
2022-07-28T00:00,78.3,44,15,30,43,90,50,40,401
2022-07-28T01:00,76.1,32,0,31,45,5,2,3,52.9
2022-07-28T02:00,75.1,49,4,55,41,0,0,0,0
2022-07-28T03:00,74.3,71,13,81,36,0,0,0,0
2022-07-28T04:00,73.5,65,25,58,24,0,0,0,0
2022-07-28T05:00,72.6,57,23,46,28,0,0,0,0
2022-07-28T06:00,71.5,81,58,36,24,0,0,0,0
2022-07-28T07:00,71.8,86,80,22,4,0,0,0,0
2022-07-28T08:00,71.7,96,84,30,7,0,0,0,0
2022-07-28T09:00,71.6,98,89,26,7,0,0,0,0
2022-07-28T10:00,71.6,83,48,33,65,0,0,0,0
2022-07-28T11:00,72,100,82,36,22,21,5,16,0
2022-07-28T12:00,73.4,61,34,36,29,89,18,71,54.2
2022-07-28T13:00,75.2,35,10,26,35,203,98,105,137.9
2022-07-28T14:00,77.1,48,34,15,27,342,182,160,258.7
2022-07-28T15:00,79.2,23,11,10,23,514,308,206,365.5
2022-07-28T16:00,81,44,12,28,54,459,187,272,323.1
2022-07-28T17:00,82.4,52,11,42,56,435,203,232,209.6
2022-07-28T18:00,84.4,82,26,64,68,522,327,195,291.7
2022-07-28T19:00,78.6,45,16,50,3,480,297,183,353.2
2022-07-28T20:00,80.1,18,2,25,4,471,297,174,351.6
2022-07-28T21:00,81.9,17,2,19,13,445,325,120,422.1
2022-07-28T22:00,82.8,30,6,13,55,437,353,84,591.8
2022-07-28T23:00,81.5,25,7,10,43,251,183,68,622.2
2022-07-29T00:00,78.8,29,6,15,49,96,57,39,442.9
2022-07-29T01:00,76.5,36,4,11,85,6,2,4,57.4
2022-07-29T02:00,74.7,37,3,9,96,0,0,0,0
2022-07-29T03:00,73.7,32,0,5,97,0,0,0,0
2022-07-29T04:00,72.8,33,0,5,100,0,0,0,0
2022-07-29T05:00,71.9,40,2,14,100,0,0,0,0
2022-07-29T06:00,71.2,38,2,19,82,0,0,0,0
2022-07-29T07:00,71,38,9,30,38,0,0,0,0
2022-07-29T08:00,70.5,20,11,13,7,0,0,0,0
2022-07-29T09:00,69.4,13,7,3,17,0,0,0,0
2022-07-29T10:00,68.4,41,38,4,14,0,0,0,0
2022-07-29T11:00,68.4,17,8,16,0,51,29,22,0
2022-07-29T12:00,72,10,3,12,1,197,140,57,417
2022-07-29T13:00,74.3,21,8,22,1,370,293,77,596.8
2022-07-29T14:00,75.8,42,8,58,0,471,356,115,622
2022-07-29T15:00,77.8,41,13,48,0,627,503,124,623.7
2022-07-29T16:00,79.4,38,18,37,0,771,617,154,703
2022-07-29T17:00,81,44,31,26,0,850,736,114,783.5
2022-07-29T18:00,81.2,27,2,42,0,756,576,180,739.5
2022-07-29T19:00,81.9,31,0,51,0,637,358,279,511.5
2022-07-29T20:00,82.2,26,4,37,0,590,404,186,461.6
2022-07-29T21:00,81.5,25,1,40,0,383,165,218,376.4
2022-07-29T22:00,81,35,1,56,0,379,239,140,351.2
2022-07-29T23:00,78.5,26,4,37,0,189,84,105,367.7
2022-07-30T00:00,76.3,20,3,28,0,71,27,44,200.1
2022-07-30T01:00,73.7,16,2,23,2,6,2,4,26.1
2022-07-30T02:00,72.1,30,2,23,47,0,0,0,0
2022-07-30T03:00,71.1,24,1,19,39,0,0,0,0
2022-07-30T04:00,71.1,13,0,13,16,0,0,0,0
2022-07-30T05:00,69.7,12,0,19,2,0,0,0,0
2022-07-30T06:00,68.4,14,0,22,1,0,0,0,0
2022-07-30T07:00,67.4,21,1,33,0,0,0,0,0
2022-07-30T08:00,66.8,8,1,11,0,0,0,0,0
2022-07-30T09:00,66.2,1,0,1,0,0,0,0,0
2022-07-30T10:00,65.5,62,44,37,0,0,0,0,0
2022-07-30T11:00,65.7,44,28,31,0,48,28,20,0
2022-07-30T12:00,68.1,21,21,4,0,198,142,56,425.2
2022-07-30T13:00,70.2,20,17,8,0,354,272,82,573.6
2022-07-30T14:00,72.4,45,32,27,0,546,452,94,682.6
2022-07-30T15:00,74.2,51,47,14,0,625,502,123,725.9
2022-07-30T16:00,75,52,56,2,0,616,372,244,551
2022-07-30T17:00,77,53,59,0,0,764,545,219,509.6
2022-07-30T18:00,78.6,50,54,2,0,824,623,201,656.5
2022-07-30T19:00,79.4,72,69,17,0,725,509,216,641.8
2022-07-30T20:00,79.8,49,30,37,0,639,412,227,549.8
2022-07-30T21:00,79.7,43,12,54,0,523,351,172,520.5
2022-07-30T22:00,79.1,16,7,16,0,417,289,128,547.1
2022-07-30T23:00,77.3,49,44,15,0,254,168,86,532.2
2022-07-31T00:00,74.1,36,39,2,0,109,70,39,475.8
2022-07-31T01:00,71,4,4,0,0,6,2,4,62.5
2022-07-31T02:00,69.2,6,7,0,0,0,0,0,0
2022-07-31T03:00,68.2,3,3,0,0,0,0,0,0
2022-07-31T04:00,68.9,1,1,0,0,0,0,0,0
2022-07-31T05:00,65.6,1,1,0,0,0,0,0,0
2022-07-31T06:00,64.8,0,0,0,0,0,0,0,0
2022-07-31T07:00,63.4,0,0,0,0,0,0,0,0
2022-07-31T08:00,62.7,0,0,0,0,0,0,0,0
2022-07-31T09:00,62.3,0,0,0,0,0,0,0,0
2022-07-31T10:00,62,5,6,0,0,0,0,0,0
2022-07-31T11:00,62.1,3,3,0,1,48,28,20,0
2022-07-31T12:00,68.3,12,2,0,35,203,149,54,444.6
2022-07-31T13:00,72.2,32,8,0,82,382,299,83,626
2022-07-31T14:00,74.8,38,16,0,79,552,432,120,701.4
2022-07-31T15:00,77,67,44,0,90,674,482,192,683.7
2022-07-31T16:00,79.2,80,55,0,100,772,556,216,659.4
2022-07-31T17:00,80.9,80,56,0,100,767,464,303,595
2022-07-31T18:00,82,67,35,9,100,744,383,361,477.6
2022-07-31T19:00,82.1,62,16,29,100,463,97,366,267.8
2022-07-31T20:00,81.7,36,1,8,100,342,47,295,74.4
2022-07-31T21:00,81.3,31,0,1,100,274,19,255,42.7
2022-07-31T22:00,79,38,7,8,89,192,9,183,19.6
2022-07-31T23:00,76.6,28,0,18,58,143,24,119,40.6
2022-08-01T00:00,75.8,19,1,17,27,69,22,47,110.1
2022-08-01T01:00,74.5,15,7,13,4,5,1,4,19.1
2022-08-01T02:00,73.5,16,14,6,0,0,0,0,0
2022-08-01T03:00,72,8,8,2,0,0,0,0,0
2022-08-01T04:00,70.7,2,2,0,0,0,0,0,0
2022-08-01T05:00,69.5,3,3,0,0,0,0,0,0
2022-08-01T06:00,68.4,1,1,0,0,0,0,0,0
2022-08-01T07:00,66.6,0,0,0,0,0,0,0,0
2022-08-01T08:00,66,0,0,0,0,0,0,0,0
2022-08-01T09:00,65.4,0,0,0,0,0,0,0,0
2022-08-01T10:00,64.8,5,6,0,0,0,0,0,0
2022-08-01T11:00,65.2,8,9,0,0,46,27,19,0
2022-08-01T12:00,69.3,12,13,0,0,201,146,55,439.7
2022-08-01T13:00,73.2,5,6,0,0,387,313,74,638.9
2022-08-01T14:00,76.6,1,1,0,0,558,472,86,749.6
2022-08-01T15:00,79.6,0,0,0,0,719,626,93,819.9
2022-08-01T16:00,81.9,9,7,5,0,786,658,128,818.3
2022-08-01T17:00,84,22,4,30,0,852,718,134,797
2022-08-01T18:00,85.7,33,0,54,2,746,587,159,730.3
2022-08-01T19:00,85.9,53,0,88,1,671,504,167,626.4
2022-08-01T20:00,85.8,59,1,96,3,388,133,255,380.4
2022-08-01T21:00,84.3,44,1,71,3,204,44,160,96.7
2022-08-01T22:00,83.1,21,0,25,21,213,96,117,117.4
2022-08-01T23:00,82.8,26,3,35,8,197,102,95,251.3
2022-08-02T00:00,80.6,41,5,36,48,84,45,39,310.1
2022-08-02T01:00,78.2,61,19,43,61,4,1,3,34.8
2022-08-02T02:00,76.5,33,8,20,45,0,0,0,0
2022-08-02T03:00,75,29,1,13,66,0,0,0,0
2022-08-02T04:00,73.7,35,0,16,84,0,0,0,0
2022-08-02T05:00,72.8,51,1,39,90,0,0,0,0
2022-08-02T06:00,72.3,57,9,48,67,0,0,0,0
2022-08-02T07:00,72.2,41,13,34,28,0,0,0,0
2022-08-02T08:00,71.9,58,30,45,14,0,0,0,0
2022-08-02T09:00,72,82,59,46,3,0,0,0,0
2022-08-02T10:00,71.8,94,83,31,1,0,0,0,0
2022-08-02T11:00,72.4,100,94,59,0,14,3,11,0
2022-08-02T12:00,73.4,97,68,59,0,62,15,47,47.8
2022-08-02T13:00,72.8,53,33,39,0,115,30,85,57.9
2022-08-02T14:00,72.9,40,27,26,0,276,126,150,127.2
2022-08-02T15:00,74.9,47,31,32,0,541,349,192,341
2022-08-02T16:00,77,41,25,30,0,664,480,184,535.4
2022-08-02T17:00,78.3,60,42,37,0,687,477,210,554
2022-08-02T18:00,80.1,60,43,35,0,752,574,178,581.2
2022-08-02T19:00,81.2,37,18,34,0,717,573,144,659.2
2022-08-02T20:00,81,41,21,36,0,579,404,175,589.4
2022-08-02T21:00,80.5,73,46,53,0,491,379,112,541.2
2022-08-02T22:00,79.3,47,19,50,0,362,265,97,560
2022-08-02T23:00,77.1,34,26,18,0,199,110,89,427.2
2022-08-03T00:00,75.1,7,4,6,0,84,49,35,325.4
2022-08-03T01:00,73,2,0,4,0,4,1,3,35.2
2022-08-03T02:00,71.3,0,0,0,0,0,0,0,0
2022-08-03T03:00,69.9,0,0,0,0,0,0,0,0
2022-08-03T04:00,68.9,0,0,0,0,0,0,0,0
2022-08-03T05:00,68.1,0,0,0,0,0,0,0,0
2022-08-03T06:00,67.2,0,0,0,0,0,0,0,0
2022-08-03T07:00,65.7,0,0,0,0,0,0,0,0
2022-08-03T08:00,64.9,0,0,0,0,0,0,0,0
2022-08-03T09:00,66.5,0,0,0,0,0,0,0,0
2022-08-03T10:00,62.9,0,0,0,0,0,0,0,0
2022-08-03T11:00,63.9,0,0,0,0,43,25,18,0
2022-08-03T12:00,68.7,0,0,0,0,196,142,54,436.9
2022-08-03T13:00,72.7,13,0,0,44,382,309,73,634.7
2022-08-03T14:00,75.8,5,5,0,0,562,477,85,756
2022-08-03T15:00,78.7,22,9,0,45,717,626,91,826.1
2022-08-03T16:00,81.8,16,0,0,53,830,732,98,866.3
2022-08-03T17:00,84.6,2,0,0,8,892,780,112,877.1
2022-08-03T18:00,87.3,1,0,0,4,902,785,117,872.2
2022-08-03T19:00,88.5,2,0,0,5,862,766,96,880
2022-08-03T20:00,90,11,0,0,38,768,675,93,879.7
2022-08-03T21:00,90.8,15,0,0,50,626,531,95,839.2
2022-08-03T22:00,90.5,15,0,0,49,456,372,84,776.5
2022-08-03T23:00,87.8,12,0,0,41,271,205,66,686.8
2022-08-04T00:00,83.6,8,0,1,26,100,64,36,529.3
2022-08-04T01:00,80.1,18,0,1,57,4,1,3,40.9
2022-08-04T02:00,78.2,25,0,1,81,0,0,0,0
2022-08-04T03:00,76.9,27,0,0,90,0,0,0,0
2022-08-04T04:00,76,28,0,0,94,0,0,0,0
2022-08-04T05:00,75.4,30,0,1,97,0,0,0,0
2022-08-04T06:00,74.8,32,0,4,100,0,0,0,0
2022-08-04T07:00,73.3,31,0,2,100,0,0,0,0
2022-08-04T08:00,72.7,29,0,0,96,0,0,0,0
2022-08-04T09:00,72.4,28,0,1,92,0,0,0,0
2022-08-04T10:00,72,33,0,10,90,0,0,0,0
2022-08-04T11:00,72.9,34,0,17,79,36,17,19,0
2022-08-04T12:00,76.5,33,5,35,26,153,97,56,302.6
2022-08-04T13:00,80.6,22,8,22,6,309,230,79,457.3
2022-08-04T14:00,84.3,17,6,20,0,482,367,115,579.8
2022-08-04T15:00,87,18,4,24,1,546,423,123,605.9
2022-08-04T16:00,89,35,9,35,19,574,360,214,507.4
2022-08-04T17:00,89.9,39,11,35,28,512,319,193,387.3
2022-08-04T18:00,90.3,41,10,29,49,615,384,231,380.4
2022-08-04T19:00,85.4,56,12,32,86,728,552,176,554.1
2022-08-04T20:00,82.3,48,1,35,88,324,146,178,425.5
2022-08-04T21:00,82.4,51,2,36,93,306,148,158,185.3
2022-08-04T22:00,81.9,52,4,30,100,273,143,130,265.8
2022-08-04T23:00,80.9,67,0,62,100,117,24,93,184.6
2022-08-05T00:00,80.2,49,2,28,100,49,8,41,56.6
2022-08-05T01:00,78.6,33,3,0,100,2,0,2,4.6
2022-08-05T02:00,78,40,2,14,100,0,0,0,0
2022-08-05T03:00,77.4,47,1,27,99,0,0,0,0
2022-08-05T04:00,76.9,48,1,30,98,0,0,0,0
2022-08-05T05:00,76.5,49,4,28,94,0,0,0,0
2022-08-05T06:00,75.6,80,39,30,90,0,0,0,0
2022-08-05T07:00,74.3,100,71,28,93,0,0,0,0
2022-08-05T08:00,73.6,100,84,15,89,0,0,0,0
2022-08-05T09:00,73.4,90,61,16,85,0,0,0,0
2022-08-05T10:00,73.5,49,9,20,97,0,0,0,0
2022-08-05T11:00,73.8,57,9,32,100,14,5,9,0
2022-08-05T12:00,74.6,36,7,0,100,66,11,55,56.8
2022-08-05T13:00,75.1,48,20,0,100,123,33,90,61.7
2022-08-05T14:00,76.2,54,25,3,100,156,3,153,42
2022-08-05T15:00,77.5,59,29,6,99,237,15,222,8.1
2022-08-05T16:00,79.5,54,25,4,98,370,51,319,38.3
2022-08-05T17:00,81.4,67,36,12,90,409,117,292,87.7
2022-08-05T18:00,83.5,51,28,17,52,586,333,253,248.6
2022-08-05T19:00,85.9,43,27,12,37,636,398,238,420.8
2022-08-05T20:00,86.9,33,14,9,50,626,467,159,545.4
2022-08-05T21:00,86,58,29,19,69,410,241,169,501.1
2022-08-05T22:00,84.2,33,5,10,74,226,99,127,275.3
2022-08-05T23:00,81.7,47,18,23,57,159,70,89,204.7
2022-08-06T00:00,80.6,43,12,10,86,56,17,39,170.1
2022-08-06T01:00,78.9,35,1,8,96,2,0,2,8.7
2022-08-06T02:00,77.7,35,1,7,99,0,0,0,0
2022-08-06T03:00,76.7,37,0,14,96,0,0,0,0
2022-08-06T04:00,75.8,35,0,9,99,0,0,0,0
2022-08-06T05:00,75.5,34,0,7,100,0,0,0,0
2022-08-06T06:00,74.9,41,4,12,100,0,0,0,0
2022-08-06T07:00,73.6,38,6,6,97,0,0,0,0
2022-08-06T08:00,73,43,8,12,95,0,0,0,0
2022-08-06T09:00,72.6,31,1,3,94,0,0,0,0
2022-08-06T10:00,72,26,0,0,88,0,0,0,0
2022-08-06T11:00,72.1,25,1,1,79,32,10,22,0
2022-08-06T12:00,74,10,1,1,28,147,69,78,201.2
2022-08-06T13:00,76.7,12,2,9,16,327,218,109,390.1
2022-08-06T14:00,79.6,12,0,19,3,492,393,99,594.7
2022-08-06T15:00,82,8,5,5,0,593,480,113,667.1
2022-08-06T16:00,84.6,9,7,5,0,682,555,127,667.7
2022-08-06T17:00,86.4,23,16,15,0,679,510,169,621.8
2022-08-06T18:00,88.2,36,22,27,0,716,564,152,600.7
2022-08-06T19:00,88.4,46,18,49,0,658,502,156,615.3
2022-08-06T20:00,88,49,26,42,1,504,371,133,534.9
2022-08-06T21:00,87.7,62,20,71,4,416,271,145,442.1
2022-08-06T22:00,86.4,43,0,71,0,328,241,87,453.9
2022-08-06T23:00,84.8,23,2,34,2,179,120,59,438.4
2022-08-07T00:00,82.6,36,15,37,2,69,41,28,330.3
2022-08-07T01:00,80.4,47,19,49,0,2,0,2,19.2
2022-08-07T02:00,79.2,41,17,43,0,0,0,0,0
2022-08-07T03:00,78.6,45,19,46,1,0,0,0,0
2022-08-07T04:00,77.7,42,11,54,0,0,0,0,0
2022-08-07T05:00,77,29,6,39,0,0,0,0,0
2022-08-07T06:00,76.5,18,2,27,0,0,0,0,0
2022-08-07T07:00,76.6,20,3,28,0,0,0,0,0
2022-08-07T08:00,76.3,45,14,54,0,0,0,0,0
2022-08-07T09:00,76,68,37,57,0,0,0,0,0
2022-08-07T10:00,75.6,47,25,39,5,0,0,0,0
2022-08-07T11:00,75.7,33,15,23,18,25,13,12,0
2022-08-07T12:00,77.5,36,9,10,74,153,96,57,283.1
2022-08-07T13:00,80.2,37,10,0,94,329,244,85,485.2
2022-08-07T14:00,82.4,45,10,22,75,495,375,120,618.2
2022-08-07T15:00,83.1,32,16,14,32,484,339,145,548.1
2022-08-07T16:00,85.5,40,12,25,48,677,525,152,543.1
2022-08-07T17:00,87.3,79,30,37,98,693,543,150,634.2
2022-08-07T18:00,88,71,26,33,93,649,502,147,588.9
2022-08-07T19:00,89.1,75,31,31,94,638,465,173,553.1
2022-08-07T20:00,89.1,70,22,34,98,550,388,162,524.7
2022-08-07T21:00,89,50,15,27,68,448,312,136,490.9
2022-08-07T22:00,88.5,34,11,18,44,330,247,83,494.4
2022-08-07T23:00,87.2,28,4,17,47,209,137,72,473.6
2022-08-08T00:00,85.1,23,1,8,58,76,44,32,372.4
2022-08-08T01:00,82.6,20,0,5,58,2,0,2,17.1
2022-08-08T02:00,80.8,14,0,1,45,0,0,0,0
2022-08-08T03:00,79.4,6,1,1,16,0,0,0,0
2022-08-08T04:00,78.3,5,2,4,3,0,0,0,0
2022-08-08T05:00,77.4,12,2,2,29,0,0,0,0
2022-08-08T06:00,76.5,24,2,2,70,0,0,0,0
2022-08-08T07:00,76.1,28,1,4,81,0,0,0,0
2022-08-08T08:00,75.6,28,3,1,83,0,0,0,0
2022-08-08T09:00,75.1,16,6,8,18,0,0,0,0
2022-08-08T10:00,74.7,5,0,1,14,0,0,0,0
2022-08-08T11:00,74.8,8,0,0,26,32,16,16,0
2022-08-08T12:00,77.8,23,0,16,44,172,118,54,355.4
2022-08-08T13:00,81.1,59,0,70,55,354,281,73,578.3
2022-08-08T14:00,84.4,71,3,88,51,533,449,84,720.6
2022-08-08T15:00,86.9,66,5,83,38,648,546,102,767.5
2022-08-08T16:00,88.4,40,5,44,30,664,533,131,700.7
2022-08-08T17:00,90,27,9,17,30,727,565,162,641.2
2022-08-08T18:00,90.7,32,7,21,43,689,532,157,621.6
2022-08-08T19:00,90.6,74,9,74,70,616,464,152,582.9
2022-08-08T20:00,88.9,100,46,99,82,312,176,136,397.1
2022-08-08T21:00,85.5,90,5,98,90,81,0,81,101.2
2022-08-08T22:00,84.6,77,8,68,98,81,26,55,13.9
2022-08-08T23:00,84.1,50,5,28,97,112,56,56,115.3
2022-08-09T00:00,83.4,42,3,22,86,58,29,29,199.4
2022-08-09T01:00,81.6,38,6,8,91,1,0,1,10.1
2022-08-09T02:00,80.5,27,1,0,86,0,0,0,0
2022-08-09T03:00,79.8,43,5,18,92,0,0,0,0
2022-08-09T04:00,79.4,54,5,41,82,0,0,0,0
2022-08-09T05:00,79.2,42,10,40,31,0,0,0,0
2022-08-09T06:00,78.9,68,31,57,21,0,0,0,0
2022-08-09T07:00,78.6,100,63,56,51,0,0,0,0
2022-08-09T08:00,78,100,87,49,71,0,0,0,0
2022-08-09T09:00,76.9,100,98,49,45,0,0,0,0
2022-08-09T10:00,74.6,100,99,80,37,0,0,0,0
2022-08-09T11:00,73.7,100,100,77,23,6,3,3,0
2022-08-09T12:00,73.5,100,100,79,1,22,5,17,27.6
2022-08-09T13:00,73,100,100,95,1,120,71,49,94.5
2022-08-09T14:00,71.9,100,100,66,0,144,69,75,152.7
2022-08-09T15:00,71.7,100,100,20,3,185,34,151,82.1
2022-08-09T16:00,72.8,91,100,1,2,253,17,236,28.9
2022-08-09T17:00,74.2,92,100,2,3,310,66,244,41.5
2022-08-09T18:00,76.6,94,100,3,7,417,170,247,141.6
2022-08-09T19:00,74.3,92,100,1,6,235,18,217,111.8
2022-08-09T20:00,74.4,94,100,0,12,252,30,222,22.7
2022-08-09T21:00,73.9,95,100,0,16,226,29,197,43.8
2022-08-09T22:00,73.2,97,98,0,30,157,13,144,36.4
2022-08-09T23:00,72.1,90,99,0,2,97,9,88,23.7
2022-08-10T00:00,70.8,89,99,0,1,36,13,23,61.2
2022-08-10T01:00,69.7,88,98,0,0,1,0,1,3.9
2022-08-10T02:00,68.6,76,84,0,2,0,0,0,0
2022-08-10T03:00,67.9,65,70,1,6,0,0,0,0
2022-08-10T04:00,66.9,32,32,2,8,0,0,0,0
2022-08-10T05:00,66.3,21,20,1,7,0,0,0,0
2022-08-10T06:00,65.6,18,18,2,3,0,0,0,0
2022-08-10T07:00,65.1,14,14,1,3,0,0,0,0
2022-08-10T08:00,64.5,9,10,0,0,0,0,0,0
2022-08-10T09:00,64,15,16,0,2,0,0,0,0
2022-08-10T10:00,63.6,68,72,4,3,0,0,0,0
2022-08-10T11:00,63.5,83,82,4,24,24,10,14,0
2022-08-10T12:00,66.6,91,88,4,31,115,60,55,202.5
2022-08-10T13:00,69.3,100,100,7,44,246,138,108,298.2
2022-08-10T14:00,70.7,100,91,8,50,283,136,147,293.9
2022-08-10T15:00,72,100,100,18,65,266,23,243,131.5
2022-08-10T16:00,72.9,100,98,11,55,268,1,267,7.1
2022-08-10T17:00,74,100,100,0,46,327,30,297,14.8
2022-08-10T18:00,75.2,96,90,0,51,368,60,308,47.8
2022-08-10T19:00,75.5,100,100,0,56,455,143,312,124.4
2022-08-10T20:00,75.5,100,100,3,34,264,29,235,105.9
2022-08-10T21:00,76.1,98,100,7,13,281,70,211,66
2022-08-10T22:00,75.8,81,89,0,3,216,75,141,131.5
2022-08-10T23:00,75,62,65,2,8,158,75,83,200.6
2022-08-11T00:00,72.9,41,33,2,33,65,32,33,232.1
2022-08-11T01:00,71.2,31,15,0,57,1,0,1,7.3
2022-08-11T02:00,69.4,23,7,3,48,0,0,0,0
2022-08-11T03:00,68.6,12,6,1,20,0,0,0,0
2022-08-11T04:00,69.5,4,4,1,0,0,0,0,0
2022-08-11T05:00,69.1,0,0,0,0,0,0,0,0
2022-08-11T06:00,67.9,0,0,0,0,0,0,0,0
2022-08-11T07:00,68.8,0,0,0,0,0,0,0,0
2022-08-11T08:00,66.1,0,0,0,0,0,0,0,0
2022-08-11T09:00,63.4,0,0,0,0,0,0,0,0
2022-08-11T10:00,63.9,1,1,0,0,0,0,0,0
2022-08-11T11:00,64,1,0,2,0,29,16,13,0
2022-08-11T12:00,68.7,18,1,14,29,166,115,51,368.5
2022-08-11T13:00,72.4,33,0,30,49,341,256,85,558.1
2022-08-11T14:00,75.1,25,0,15,52,497,394,103,649
2022-08-11T15:00,77.4,17,14,5,5,652,533,119,715.5
2022-08-11T16:00,78.4,22,23,3,0,697,554,143,717
2022-08-11T17:00,78.6,20,22,1,0,687,513,174,623.9
2022-08-11T18:00,79.8,24,18,13,0,783,649,134,657.3
2022-08-11T19:00,80.4,28,4,41,0,752,588,164,726.5
2022-08-11T20:00,79.8,25,0,41,0,605,452,153,647.3
2022-08-11T21:00,78.3,19,1,30,0,478,348,130,570.4
2022-08-11T22:00,75.9,20,3,28,0,344,237,107,522
2022-08-11T23:00,74,24,5,32,0,197,139,58,478.5
2022-08-12T00:00,72,15,3,20,0,76,47,29,382.9
2022-08-12T01:00,69.9,13,1,20,0,1,0,1,8.2
2022-08-12T02:00,68.4,15,3,21,0,0,0,0,0
2022-08-12T03:00,67.4,9,1,14,0,0,0,0,0
2022-08-12T04:00,66.3,11,7,8,0,0,0,0,0
2022-08-12T05:00,65.7,15,7,14,0,0,0,0,0
2022-08-12T06:00,64.8,22,13,17,0,0,0,0,0
2022-08-12T07:00,63.9,40,28,25,0,0,0,0,0
2022-08-12T08:00,63.4,26,14,22,0,0,0,0,0
2022-08-12T09:00,62.9,34,21,25,0,0,0,0,0
2022-08-12T10:00,62.5,11,5,11,0,0,0,0,0
2022-08-12T11:00,62.4,1,0,2,0,28,15,13,0
2022-08-12T12:00,64.5,0,0,0,0,176,126,50,387.9
2022-08-12T13:00,66.8,3,3,0,0,366,294,72,636.7
2022-08-12T14:00,69,19,21,0,0,530,426,104,727.5
2022-08-12T15:00,71,26,29,0,0,695,582,113,778.6
2022-08-12T16:00,72.3,23,25,0,0,747,604,143,780.5
2022-08-12T17:00,73.8,23,26,0,0,830,653,177,740.5
2022-08-12T18:00,74.7,13,14,0,0,859,680,179,757.3
2022-08-12T19:00,75.2,8,9,0,0,843,714,129,811.3
2022-08-12T20:00,75.3,3,3,0,0,741,629,112,845.8
2022-08-12T21:00,74.6,1,1,0,0,604,492,112,807
2022-08-12T22:00,73.3,0,0,0,0,436,352,84,762
2022-08-12T23:00,71.6,0,0,0,0,252,195,57,705.9
2022-08-13T00:00,69,0,0,0,0,77,49,28,481.8
2022-08-13T01:00,66.8,0,0,0,0,1,0,1,6.2
2022-08-13T02:00,65.2,0,0,0,0,0,0,0,0
2022-08-13T03:00,63.7,0,0,0,0,0,0,0,0
2022-08-13T04:00,63,0,0,0,0,0,0,0,0
2022-08-13T05:00,62,0,0,0,0,0,0,0,0
2022-08-13T06:00,61.2,0,0,0,0,0,0,0,0
2022-08-13T07:00,59.6,0,0,0,0,0,0,0,0
2022-08-13T08:00,58.5,0,0,0,0,0,0,0,0
2022-08-13T09:00,57.6,0,0,0,0,0,0,0,0
2022-08-13T10:00,57.8,0,0,0,0,0,0,0,0
2022-08-13T11:00,60.6,0,0,0,0,28,16,12,0
2022-08-13T12:00,62.7,0,0,0,0,178,129,49,409.3
2022-08-13T13:00,68.5,0,0,0,0,370,301,69,654.5
2022-08-13T14:00,71.3,0,0,0,0,555,472,83,780.1
2022-08-13T15:00,73.3,0,0,0,0,715,626,89,850.8
2022-08-13T16:00,75,0,0,0,0,833,738,95,894
2022-08-13T17:00,76.5,0,0,0,0,901,805,96,918.4
2022-08-13T18:00,77.8,1,0,1,0,906,793,113,914.7
2022-08-13T19:00,78.4,1,0,1,0,865,768,97,910.3
2022-08-13T20:00,78.7,0,0,0,0,754,654,100,893.5
2022-08-13T21:00,78.3,0,0,0,0,619,537,82,862.7
2022-08-13T22:00,77.4,0,0,0,0,441,371,70,827.3
2022-08-13T23:00,75.1,1,0,0,2,246,188,58,720.2
2022-08-14T00:00,71.6,2,0,0,6,73,47,26,463.1
2022-08-14T01:00,68.8,2,0,0,5,0,0,0,4.2
2022-08-14T02:00,67,4,0,0,14,0,0,0,0
2022-08-14T03:00,64.7,4,0,0,12,0,0,0,0
2022-08-14T04:00,64.4,1,0,0,2,0,0,0,0
2022-08-14T05:00,62.9,1,0,1,0,0,0,0,0
2022-08-14T06:00,61.5,4,0,7,0,0,0,0,0
2022-08-14T07:00,60.3,4,0,7,0,0,0,0,0
2022-08-14T08:00,59.9,7,0,11,0,0,0,0,0
2022-08-14T09:00,59,5,0,9,0,0,0,0,0
2022-08-14T10:00,58.5,7,0,11,0,0,0,0,0
2022-08-14T11:00,58.7,4,0,7,0,25,12,13,0
2022-08-14T12:00,63.5,7,2,8,0,163,111,52,341.3
2022-08-14T13:00,69.6,7,2,8,0,349,271,78,583.3
2022-08-14T14:00,74,5,1,6,0,530,433,97,711.7
2022-08-14T15:00,77.4,14,1,21,0,701,611,90,809.7
2022-08-14T16:00,79.9,5,0,9,0,819,712,107,873
2022-08-14T17:00,81.8,36,0,60,0,872,762,110,889.2
2022-08-14T18:00,82.2,58,0,97,0,735,557,178,770.8
2022-08-14T19:00,81,55,0,91,0,519,304,215,499.2
2022-08-14T20:00,81.2,58,0,96,0,433,146,287,265.9
2022-08-14T21:00,81.4,58,0,97,0,381,171,210,230.9
2022-08-14T22:00,79.8,39,0,64,2,222,79,143,225.1
2022-08-14T23:00,77.3,36,0,57,6,134,52,82,167.9
2022-08-15T00:00,74.6,30,0,50,0,47,23,24,163.2
2022-08-15T01:00,72.3,32,0,54,0,0,0,0,1.2
2022-08-15T02:00,71.2,33,0,55,0,0,0,0,0
2022-08-15T03:00,70,40,0,66,0,0,0,0,0
2022-08-15T04:00,68.7,43,0,71,0,0,0,0,0
2022-08-15T05:00,67.5,39,0,65,0,0,0,0,0
2022-08-15T06:00,66.1,31,0,51,0,0,0,0,0
2022-08-15T07:00,64.2,32,0,54,0,0,0,0,0
2022-08-15T08:00,64,11,0,19,0,0,0,0,0
2022-08-15T09:00,63.4,13,0,21,0,0,0,0,0
2022-08-15T10:00,63,23,0,39,0,0,0,0,0
2022-08-15T11:00,63.1,1,0,2,0,22,11,11,0
2022-08-15T12:00,67.1,5,0,9,0,160,112,48,344.4
2022-08-15T13:00,71.7,17,0,29,0,318,237,81,547.8
2022-08-15T14:00,75.7,26,0,43,0,512,424,88,664.3
2022-08-15T15:00,78.8,31,0,51,0,666,553,113,773
2022-08-15T16:00,80.1,52,0,84,5,667,533,134,726.9
2022-08-15T17:00,80,60,0,97,7,611,480,131,611.1
2022-08-15T18:00,80.6,53,0,87,1,541,317,224,452.7
2022-08-15T19:00,82,36,0,52,16,605,376,229,399.4
2022-08-15T20:00,82.2,41,0,45,47,514,322,192,457.7
2022-08-15T21:00,80.7,58,0,56,80,253,81,172,282.5
2022-08-15T22:00,79.1,66,0,67,85,176,59,117,116.4
2022-08-15T23:00,77,62,0,78,51,103,35,68,123.5
2022-08-16T00:00,74.8,49,1,74,11,40,15,25,108
2022-08-16T01:00,72.9,51,0,74,23,0,0,0,0.3
2022-08-16T02:00,71.5,67,0,81,60,0,0,0,0
2022-08-16T03:00,70.7,82,0,95,84,0,0,0,0
2022-08-16T04:00,69.9,64,0,61,90,0,0,0,0
2022-08-16T05:00,69,68,0,68,90,0,0,0,0
2022-08-16T06:00,68.5,68,0,66,96,0,0,0,0
2022-08-16T07:00,68.4,54,0,43,93,0,0,0,0
2022-08-16T08:00,67.6,49,0,40,83,0,0,0,0
2022-08-16T09:00,67,40,0,22,88,0,0,0,0
2022-08-16T10:00,65.7,40,0,20,93,0,0,0,0
2022-08-16T11:00,66.1,46,0,30,94,17,4,13,0
2022-08-16T12:00,69,47,0,29,97,96,22,74,85.9
2022-08-16T13:00,71.9,36,0,13,94,184,49,135,105.8
2022-08-16T14:00,74.7,38,0,17,92,353,149,204,187.5
2022-08-16T15:00,76.9,32,0,9,87,484,253,231,312.6
2022-08-16T16:00,78.2,35,5,13,75,593,343,250,395.4
2022-08-16T17:00,80,45,20,16,58,685,367,318,434.6
2022-08-16T18:00,80.7,33,4,19,59,591,241,350,348.4
2022-08-16T19:00,81,48,6,44,54,534,313,221,319.8
2022-08-16T20:00,81,51,9,28,87,481,285,196,386
2022-08-16T21:00,80.8,43,5,17,93,397,212,185,368.9
2022-08-16T22:00,75.9,50,1,31,100,216,102,114,287.7
2022-08-16T23:00,73.7,62,0,54,100,115,23,92,145.8
2022-08-17T00:00,72,35,0,11,94,41,12,29,72
2022-08-17T01:00,70.1,20,0,5,58,0,0,0,0.1
2022-08-17T02:00,69.3,14,2,6,30,0,0,0,0
2022-08-17T03:00,68.5,18,1,6,44,0,0,0,0
2022-08-17T04:00,68.2,40,2,32,62,0,0,0,0
2022-08-17T05:00,67.8,44,1,32,78,0,0,0,0
2022-08-17T06:00,67.3,36,3,21,69,0,0,0,0
2022-08-17T07:00,65.1,35,4,19,68,0,0,0,0
2022-08-17T08:00,65,38,10,7,84,0,0,0,0
2022-08-17T09:00,64.7,47,4,26,91,0,0,0,0
2022-08-17T10:00,64.3,58,2,50,88,0,0,0,0
2022-08-17T11:00,63.9,47,1,34,87,14,3,11,0
2022-08-17T12:00,66.1,48,6,30,83,106,33,73,100.1
2022-08-17T13:00,68.5,65,2,67,78,231,94,137,189.5
2022-08-17T14:00,70.4,86,10,87,83,385,226,159,312.8
2022-08-17T15:00,73.3,78,5,80,84,580,389,191,483.4
2022-08-17T16:00,74.5,41,7,22,73,648,415,233,542.9
2022-08-17T17:00,75.2,67,19,42,83,663,416,247,501
2022-08-17T18:00,75.8,78,17,64,81,622,376,246,453
2022-08-17T19:00,80.9,50,6,37,74,678,454,224,492.1
2022-08-17T20:00,80.4,53,7,44,66,541,336,205,511.2
2022-08-17T21:00,79.2,79,1,86,89,374,216,158,403.8
2022-08-17T22:00,77,79,0,88,87,258,115,143,299.4
2022-08-17T23:00,75.3,35,0,10,95,141,63,78,236.9
2022-08-18T00:00,72.8,58,0,47,98,44,17,27,160.3
2022-08-18T01:00,71,31,0,2,99,0,0,0,0
2022-08-18T02:00,69.8,3,0,0,9,0,0,0,0
2022-08-18T03:00,68.4,7,0,4,15,0,0,0,0
2022-08-18T04:00,67.4,15,0,2,47,0,0,0,0
2022-08-18T05:00,66.6,28,0,5,84,0,0,0,0
2022-08-18T06:00,65.7,32,0,6,93,0,0,0,0
2022-08-18T07:00,64.8,31,0,1,100,0,0,0,0
2022-08-18T08:00,64.6,30,0,0,100,0,0,0,0
2022-08-18T09:00,64.3,31,1,0,99,0,0,0,0
2022-08-18T10:00,64,100,89,14,100,0,0,0,0
2022-08-18T11:00,63.9,100,98,17,100,14,0,14,0
2022-08-18T12:00,66.4,100,83,6,100,100,21,79,44.4
2022-08-18T13:00,69.5,69,38,9,99,226,70,156,135.9
2022-08-18T14:00,72.3,38,4,9,97,378,158,220,223.1
2022-08-18T15:00,75.2,33,1,5,96,546,324,222,368.8
2022-08-18T16:00,77.5,41,4,14,95,699,476,223,532.2
2022-08-18T17:00,79.1,53,2,37,96,793,562,231,629.5
2022-08-18T18:00,80,70,8,55,99,804,578,226,678.9
2022-08-18T19:00,79,67,16,39,97,563,265,298,503.5
2022-08-18T20:00,79,57,3,42,96,408,148,260,246.9
2022-08-18T21:00,78.6,54,2,38,99,364,137,227,210.9
2022-08-18T22:00,77.7,52,5,29,99,207,64,143,184.6
2022-08-18T23:00,76,57,0,45,100,136,39,97,140.5
2022-08-19T00:00,73.8,29,0,3,91,33,8,25,91.8
2022-08-19T01:00,72,29,1,6,83,0,0,0,0
2022-08-19T02:00,70.7,18,1,1,56,0,0,0,0
2022-08-19T03:00,69.5,11,1,2,31,0,0,0,0
2022-08-19T04:00,68.6,10,1,6,17,0,0,0,0
2022-08-19T05:00,67.5,8,0,8,9,0,0,0,0
2022-08-19T06:00,66.2,9,0,11,9,0,0,0,0
2022-08-19T07:00,64.8,2,0,2,1,0,0,0,0
2022-08-19T08:00,64.4,2,0,3,1,0,0,0,0
2022-08-19T09:00,63.9,3,0,5,1,0,0,0,0
2022-08-19T10:00,63.5,1,0,0,3,0,0,0,0
2022-08-19T11:00,63.3,1,0,0,4,18,9,9,0
2022-08-19T12:00,66.1,1,0,0,2,147,96,51,307.4
2022-08-19T13:00,72.9,0,0,0,1,331,255,76,554.5
2022-08-19T14:00,76.7,0,0,0,0,515,423,92,704.7
2022-08-19T15:00,79.6,1,0,2,0,673,575,98,792.5
2022-08-19T16:00,81.6,16,6,18,0,765,669,96,842.8
2022-08-19T17:00,82.9,17,2,26,0,655,526,129,730.7
2022-08-19T18:00,84.1,16,0,27,0,656,503,153,586.7
2022-08-19T19:00,85.3,22,0,36,0,679,560,119,632.7
2022-08-19T20:00,85.3,17,0,29,0,593,468,125,666.6
2022-08-19T21:00,85.1,17,0,29,0,455,359,96,617.7
2022-08-19T22:00,83.9,26,0,44,0,296,218,78,538.8
2022-08-19T23:00,81.5,28,0,46,0,172,125,47,478.5
2022-08-20T00:00,78.4,27,0,43,4,42,23,19,284.4
2022-08-20T01:00,75.3,17,0,24,9,0,0,0,0
2022-08-20T02:00,72.9,20,0,29,8,0,0,0,0
2022-08-20T03:00,71.1,14,0,22,3,0,0,0,0
2022-08-20T04:00,70.4,17,0,27,2,0,0,0,0
2022-08-20T05:00,69.2,11,0,17,1,0,0,0,0
2022-08-20T06:00,68.7,14,0,22,2,0,0,0,0
2022-08-20T07:00,68.8,8,0,13,1,0,0,0,0
2022-08-20T08:00,68.4,8,0,12,1,0,0,0,0
2022-08-20T09:00,67.6,3,0,5,0,0,0,0,0
2022-08-20T10:00,67.1,4,0,6,0,0,0,0,0
2022-08-20T11:00,67.1,4,0,6,0,16,8,8,0
2022-08-20T12:00,70.1,4,0,7,0,142,97,45,306.1
2022-08-20T13:00,76.4,8,0,14,0,323,253,70,562.6
2022-08-20T14:00,80.7,9,0,15,0,487,403,84,696
2022-08-20T15:00,83,8,0,13,0,520,421,99,662.4
2022-08-20T16:00,85.5,31,0,52,0,698,592,106,684.4
2022-08-20T17:00,85.5,29,0,49,0,497,311,186,565
2022-08-20T18:00,85.7,30,0,50,0,466,284,182,328.6
2022-08-20T19:00,86.4,24,0,37,5,503,347,156,369.1
2022-08-20T20:00,87.5,17,0,24,9,544,419,125,501.3
2022-08-20T21:00,87.3,19,0,23,16,444,352,92,589.2
2022-08-20T22:00,85.7,45,0,37,77,298,214,84,545.4
2022-08-20T23:00,82.6,46,0,30,92,98,56,42,343.7
2022-08-21T00:00,79.7,41,2,29,72,37,18,19,140.8
2022-08-21T01:00,77,35,3,43,22,0,0,0,0
2022-08-21T02:00,75.4,47,1,40,73,0,0,0,0
2022-08-21T03:00,74,45,0,29,91,0,0,0,0
2022-08-21T04:00,73.3,48,1,30,97,0,0,0,0
2022-08-21T05:00,72.6,44,1,24,97,0,0,0,0
2022-08-21T06:00,72.6,30,1,20,56,0,0,0,0
2022-08-21T07:00,71.3,37,0,14,94,0,0,0,0
2022-08-21T08:00,71,38,0,13,100,0,0,0,0
2022-08-21T09:00,70.4,36,0,10,100,0,0,0,0
2022-08-21T10:00,70.2,62,0,54,100,0,0,0,0
2022-08-21T11:00,70.2,86,2,92,97,11,1,10,0
2022-08-21T12:00,70.6,68,8,54,93,61,6,55,26.2
2022-08-21T13:00,68.6,71,13,52,95,70,4,66,20.7
2022-08-21T14:00,69.1,82,20,62,90,92,0,92,3.9
2022-08-21T15:00,71.8,69,6,72,69,155,8,147,1.1
2022-08-21T16:00,76.3,58,9,47,73,399,117,282,76.6
2022-08-21T17:00,79.8,50,17,15,87,474,174,300,178.5
2022-08-21T18:00,82.3,64,14,37,96,528,237,291,245.6
2022-08-21T19:00,79.5,61,15,30,97,455,171,284,249.8
2022-08-21T20:00,80.3,57,16,22,98,360,103,257,174.3
2022-08-21T21:00,80.8,52,17,12,98,328,76,252,133.6
2022-08-21T22:00,80.2,71,8,58,97,204,35,169,103.7
2022-08-21T23:00,77.8,69,10,52,96,99,16,83,65.1
2022-08-22T00:00,76.2,42,9,10,92,31,11,20,59
2022-08-22T01:00,74.4,44,9,12,94,0,0,0,0
2022-08-22T02:00,73.3,44,11,10,95,0,0,0,0
2022-08-22T03:00,72.6,46,9,14,98,0,0,0,0
2022-08-22T04:00,72,50,7,23,100,0,0,0,0
2022-08-22T05:00,71.4,57,15,22,100,0,0,0,0
2022-08-22T06:00,70.9,86,30,48,100,0,0,0,0
2022-08-22T07:00,69.6,100,84,41,98,0,0,0,0
2022-08-22T08:00,68.4,100,92,70,99,0,0,0,0
2022-08-22T09:00,67.8,100,95,82,97,0,0,0,0
2022-08-22T10:00,67.4,100,75,93,99,0,0,0,0
2022-08-22T11:00,67.1,100,43,89,100,2,0,2,0
2022-08-22T12:00,67.4,85,30,49,94,20,0,20,0
2022-08-22T13:00,67.6,92,31,62,88,44,0,44,0
2022-08-22T14:00,68.3,100,56,53,75,100,0,100,0
2022-08-22T15:00,70.1,96,65,36,52,204,5,199,0.7
2022-08-22T16:00,72,90,59,37,49,278,69,209,48.6
2022-08-22T17:00,73.2,53,28,15,63,315,40,275,67.2
2022-08-22T18:00,74.4,57,20,30,70,425,117,308,83.8
2022-08-22T19:00,75.6,43,20,10,63,458,229,229,216.7
2022-08-22T20:00,74.6,86,60,21,66,306,128,178,225.1
2022-08-22T21:00,75.7,72,48,14,69,384,271,113,308.6
2022-08-22T22:00,74.7,69,17,51,76,309,208,101,488.2
2022-08-22T23:00,72.8,74,20,52,81,129,57,72,357.9
2022-08-23T00:00,72,52,13,20,93,29,8,21,112
2022-08-23T01:00,70.3,82,22,59,89,0,0,0,0
2022-08-23T02:00,68.7,43,15,4,89,0,0,0,0
2022-08-23T03:00,69.1,84,45,31,83,0,0,0,0
2022-08-23T04:00,68,100,73,23,84,0,0,0,0
2022-08-23T05:00,67.5,63,49,15,32,0,0,0,0
2022-08-23T06:00,67.3,79,79,9,7,0,0,0,0
2022-08-23T07:00,67,95,97,13,0,0,0,0,0
2022-08-23T08:00,66.8,93,92,17,1,0,0,0,0
2022-08-23T09:00,66.6,76,71,18,3,0,0,0,0
2022-08-23T10:00,66.6,75,54,7,73,0,0,0,0
2022-08-23T11:00,66.8,100,81,44,75,6,1,5,0
2022-08-23T12:00,67.5,100,84,83,74,49,4,45,16.3
2022-08-23T13:00,68.7,100,97,61,80,158,61,97,83.9
2022-08-23T14:00,71.1,100,78,73,93,286,144,142,218.6
2022-08-23T15:00,72,100,98,38,96,317,130,187,230.1
2022-08-23T16:00,73.9,100,87,49,91,375,154,221,186.3
2022-08-23T17:00,76.1,100,72,71,92,465,224,241,231.5
2022-08-23T18:00,74.2,100,42,87,93,371,203,168,264.9
2022-08-23T19:00,70.6,100,80,97,96,190,10,180,126.5
2022-08-23T20:00,70,100,76,74,92,179,8,171,1.7
2022-08-23T21:00,70.6,100,83,43,93,287,92,195,80.4
2022-08-23T22:00,71.3,52,11,25,91,195,85,110,183.1
2022-08-23T23:00,71,49,4,31,90,100,43,57,186.4
2022-08-24T00:00,70,43,2,23,92,26,11,15,101.4
2022-08-24T01:00,69.8,39,2,14,95,0,0,0,0
2022-08-24T02:00,69.5,49,7,22,97,0,0,0,0
2022-08-24T03:00,69.1,41,3,16,94,0,0,0,0
2022-08-24T04:00,68.4,37,2,23,71,0,0,0,0
2022-08-24T05:00,68.1,22,1,10,49,0,0,0,0
2022-08-24T06:00,67.4,5,0,4,10,0,0,0,0
2022-08-24T07:00,66.6,2,0,4,0,0,0,0,0
2022-08-24T08:00,65.5,2,0,4,0,0,0,0,0
2022-08-24T09:00,64.7,2,1,2,0,0,0,0,0
2022-08-24T10:00,63.9,7,4,5,0,0,0,0,0
2022-08-24T11:00,63.7,13,8,10,0,13,6,7,0
2022-08-24T12:00,67.2,9,5,8,0,136,91,45,292.6
2022-08-24T13:00,71.1,8,6,5,0,320,252,68,570.3
2022-08-24T14:00,74.2,21,12,17,0,499,413,86,714
2022-08-24T15:00,77.2,9,4,9,0,655,557,98,785.8
2022-08-24T16:00,79.3,5,0,9,0,774,677,97,843.1
2022-08-24T17:00,80.7,2,0,3,0,796,668,128,842
2022-08-24T18:00,81.1,6,0,10,0,655,465,190,670.5
2022-08-24T19:00,81.9,23,0,38,0,631,465,166,554
2022-08-24T20:00,82,29,0,49,0,560,402,158,572.9
2022-08-24T21:00,81.4,23,0,38,0,438,307,131,540.8
2022-08-24T22:00,80.8,11,0,18,0,324,236,88,539.5
2022-08-24T23:00,77.8,1,0,1,0,173,115,58,517.9
2022-08-25T00:00,75.9,1,0,1,0,37,21,16,245.6
2022-08-25T01:00,73.9,1,0,1,0,0,0,0,0
2022-08-25T02:00,72,1,0,1,0,0,0,0,0
2022-08-25T03:00,69.8,1,0,2,0,0,0,0,0
2022-08-25T04:00,71.5,2,0,3,2,0,0,0,0
2022-08-25T05:00,70.5,6,0,1,17,0,0,0,0
2022-08-25T06:00,67.5,8,0,4,19,0,0,0,0
2022-08-25T07:00,65.7,8,0,13,0,0,0,0,0
2022-08-25T08:00,65.4,7,0,12,0,0,0,0,0
2022-08-25T09:00,64.8,8,0,13,0,0,0,0,0
2022-08-25T10:00,64.5,30,1,49,0,0,0,0,0
2022-08-25T11:00,64.8,31,3,32,30,11,5,6,0
2022-08-25T12:00,68.6,44,1,36,70,127,82,45,263.8
2022-08-25T13:00,74.1,33,3,29,42,305,233,72,527.3
2022-08-25T14:00,76.7,21,3,23,14,468,382,86,665.6
2022-08-25T15:00,79.1,14,6,13,1,610,502,108,724.9
2022-08-25T16:00,80.4,39,19,29,15,656,532,124,709.5
2022-08-25T17:00,81.9,20,10,19,0,716,585,131,690.4
2022-08-25T18:00,82.3,20,12,14,1,665,530,135,671.2
2022-08-25T19:00,81.5,20,14,13,0,543,390,153,548.1
2022-08-25T20:00,82.5,27,10,30,0,601,484,117,583.4
2022-08-25T21:00,79.8,35,11,31,21,380,293,87,603.5
2022-08-25T22:00,78.2,77,33,39,78,259,186,73,470.2
2022-08-25T23:00,75,31,6,28,29,126,74,52,377.8
2022-08-26T00:00,73.6,17,0,21,15,24,10,14,145.3
2022-08-26T01:00,72.5,16,0,20,12,0,0,0,0
2022-08-26T02:00,71.3,17,0,28,1,0,0,0,0
2022-08-26T03:00,70.2,27,1,43,0,0,0,0,0
2022-08-26T04:00,69.7,31,1,44,12,0,0,0,0
2022-08-26T05:00,69.3,19,0,16,30,0,0,0,0
2022-08-26T06:00,69,21,0,8,53,0,0,0,0
2022-08-26T07:00,68.4,41,0,45,46,0,0,0,0
2022-08-26T08:00,68.3,45,2,62,19,0,0,0,0
2022-08-26T09:00,68,38,1,42,41,0,0,0,0
2022-08-26T10:00,67.7,73,0,89,65,0,0,0,0
2022-08-26T11:00,67.4,75,1,79,90,8,2,6,0
2022-08-26T12:00,68.5,61,0,55,92,88,47,41,145
2022-08-26T13:00,70.8,63,9,54,75,208,116,92,276
2022-08-26T14:00,73.9,50,8,27,90,411,289,122,424.3
2022-08-26T15:00,76.3,40,7,13,87,493,335,158,522.3
2022-08-26T16:00,79.2,39,14,5,78,605,405,200,502.5
2022-08-26T17:00,81,50,25,11,70,694,478,216,561.3
2022-08-26T18:00,81,54,28,15,66,477,200,277,414.7
2022-08-26T19:00,76.5,36,13,12,57,377,116,261,170.6
2022-08-26T20:00,74.3,44,27,13,38,424,240,184,238.6
2022-08-26T21:00,75.5,53,20,35,48,323,171,152,326.8
2022-08-26T22:00,74.6,46,15,16,76,207,112,95,281.6
2022-08-26T23:00,73.2,44,16,14,70,113,55,58,254.5
2022-08-27T00:00,71.8,47,20,20,58,17,6,11,104.6
2022-08-27T01:00,70.7,39,23,15,32,0,0,0,0
2022-08-27T02:00,69.7,66,49,34,5,0,0,0,0
2022-08-27T03:00,69.1,51,39,27,0,0,0,0,0
2022-08-27T04:00,68.4,30,28,8,0,0,0,0,0
2022-08-27T05:00,67.6,26,28,2,0,0,0,0,0
2022-08-27T06:00,67.3,34,38,0,0,0,0,0,0
2022-08-27T07:00,66.8,50,55,0,0,0,0,0,0
2022-08-27T08:00,66.2,49,54,0,0,0,0,0,0
2022-08-27T09:00,65.7,49,54,0,0,0,0,0,0
2022-08-27T10:00,65.2,53,59,0,0,0,0,0,0
2022-08-27T11:00,64.8,62,69,0,0,7,1,6,0
2022-08-27T12:00,65,82,91,0,0,94,46,48,128.9
2022-08-27T13:00,66,58,64,0,0,225,136,89,308.5
2022-08-27T14:00,67.8,63,70,0,0,365,262,103,426.9
2022-08-27T15:00,70.5,70,78,0,0,534,381,153,534.3
2022-08-27T16:00,72.2,64,71,0,0,570,349,221,507.5
2022-08-27T17:00,73.3,63,70,0,0,646,442,204,474.8
2022-08-27T18:00,75.3,62,69,0,0,809,660,149,666.2
2022-08-27T19:00,77.6,35,39,0,0,717,544,173,742.9
2022-08-27T20:00,77.8,4,4,0,0,685,585,100,754.3
2022-08-27T21:00,77.4,2,2,0,0,542,458,84,824.4
2022-08-27T22:00,76,0,0,0,0,365,292,73,757.3
2022-08-27T23:00,73.6,0,0,0,0,179,129,50,639.3
2022-08-28T00:00,70.6,0,0,0,0,30,17,13,244.3
2022-08-28T01:00,68.7,0,0,0,0,0,0,0,0
2022-08-28T02:00,67.3,0,0,0,0,0,0,0,0
2022-08-28T03:00,66.1,0,0,0,0,0,0,0,0
2022-08-28T04:00,64.9,0,0,0,0,0,0,0,0
2022-08-28T05:00,63.8,0,0,0,0,0,0,0,0
2022-08-28T06:00,63,1,0,0,2,0,0,0,0
2022-08-28T07:00,62.5,1,0,0,4,0,0,0,0
2022-08-28T08:00,61.8,0,0,0,1,0,0,0,0
2022-08-28T09:00,61.3,0,0,0,0,0,0,0,0
2022-08-28T10:00,61.3,0,0,0,0,0,0,0,0
2022-08-28T11:00,61.7,2,1,0,5,10,4,6,0
2022-08-28T12:00,64.8,3,2,0,4,129,87,42,281.2
2022-08-28T13:00,70.7,4,4,0,0,312,244,68,575
2022-08-28T14:00,75.3,9,10,0,0,495,414,81,721.9
2022-08-28T15:00,79.5,9,10,0,0,651,562,89,806.1
2022-08-28T16:00,82.8,5,5,0,0,777,683,94,863.3
2022-08-28T17:00,85,48,29,37,0,804,694,110,872.9
2022-08-28T18:00,85.8,34,3,52,0,684,515,169,738.8
2022-08-28T19:00,86.4,32,0,54,0,556,293,263,491.6
2022-08-28T20:00,86.7,23,0,36,4,430,191,239,316.5
2022-08-28T21:00,86.7,44,0,51,43,283,101,182,223.7
2022-08-28T22:00,84.6,61,0,67,68,168,53,115,148
2022-08-28T23:00,81.9,52,0,44,84,104,39,65,149.6
2022-08-29T00:00,78.3,29,0,8,79,23,8,15,80
2022-08-29T01:00,76.1,20,0,1,64,0,0,0,0
2022-08-29T02:00,74.6,13,0,2,40,0,0,0,0
2022-08-29T03:00,73.2,6,0,0,20,0,0,0,0
2022-08-29T04:00,72.3,3,1,1,5,0,0,0,0
2022-08-29T05:00,71.9,5,3,2,3,0,0,0,0
2022-08-29T06:00,71.7,13,1,0,40,0,0,0,0
2022-08-29T07:00,72,28,0,0,93,0,0,0,0
2022-08-29T08:00,71.6,29,1,0,95,0,0,0,0
2022-08-29T09:00,71.6,43,14,0,100,0,0,0,0
2022-08-29T10:00,71.9,77,52,0,100,0,0,0,0
2022-08-29T11:00,72.5,37,10,0,94,7,1,6,0
2022-08-29T12:00,74.4,38,14,9,66,100,48,52,134.3
2022-08-29T13:00,77.4,40,22,30,6,285,191,94,394.4
2022-08-29T14:00,80.8,20,7,22,2,457,361,96,607.7
2022-08-29T15:00,83.5,12,4,9,9,571,484,87,707
2022-08-29T16:00,86.4,10,0,6,22,676,539,137,710
2022-08-29T17:00,88.4,16,2,23,0,745,640,105,735.7
2022-08-29T18:00,89.5,19,4,26,0,774,667,107,796.6
2022-08-29T19:00,90.3,11,0,18,0,701,568,133,766.8
2022-08-29T20:00,90.7,17,3,23,0,592,477,115,704.4
2022-08-29T21:00,89.6,41,13,44,10,443,343,100,652.5
2022-08-29T22:00,87.1,25,1,35,11,254,173,81,521.4
2022-08-29T23:00,84.5,23,4,23,19,99,63,36,353.3
2022-08-30T00:00,81.9,42,8,44,27,21,10,11,115.5
2022-08-30T01:00,80.1,53,5,53,54,0,0,0,0
2022-08-30T02:00,79.4,51,1,49,68,0,0,0,0
2022-08-30T03:00,78.7,47,1,34,84,0,0,0,0
2022-08-30T04:00,78,42,0,23,95,0,0,0,0
2022-08-30T05:00,77.4,16,0,3,46,0,0,0,0
2022-08-30T06:00,76.5,17,0,8,39,0,0,0,0
2022-08-30T07:00,76.5,17,0,8,40,0,0,0,0
2022-08-30T08:00,76,22,0,13,48,0,0,0,0
2022-08-30T09:00,75.3,43,7,16,91,0,0,0,0
2022-08-30T10:00,74.7,57,15,28,88,0,0,0,0
2022-08-30T11:00,74,49,10,23,87,6,1,5,0
2022-08-30T12:00,74.8,28,4,24,32,74,27,47,85.2
2022-08-30T13:00,76.6,64,2,78,51,180,99,81,219.4
2022-08-30T14:00,78.6,63,0,65,80,239,102,137,245.3
2022-08-30T15:00,79,75,1,79,90,155,19,136,109.7
2022-08-30T16:00,78.7,84,14,76,85,171,1,170,7.2
2022-08-30T17:00,78.6,100,24,96,92,202,24,178,7.9
2022-08-30T18:00,81,100,36,99,99,355,142,213,107.4
2022-08-30T19:00,74.8,100,77,99,98,109,6,103,97.4
2022-08-30T20:00,73.8,100,86,91,99,98,1,97,0.7
2022-08-30T21:00,72,100,42,100,100,57,2,55,2.5
2022-08-30T22:00,70,92,2,100,100,29,0,29,1.8
2022-08-30T23:00,68.8,93,3,100,100,12,0,12,0
2022-08-31T00:00,68.3,94,19,79,99,4,0,4,0
2022-08-31T01:00,67.8,51,14,20,88,0,0,0,0
2022-08-31T02:00,68.5,41,7,15,85,0,0,0,0
2022-08-31T03:00,68.2,31,14,20,23,0,0,0,0
2022-08-31T04:00,67.5,36,19,29,5,0,0,0,0
2022-08-31T05:00,67.1,55,30,45,2,0,0,0,0
2022-08-31T06:00,66.6,66,46,41,0,0,0,0,0
2022-08-31T07:00,65.8,60,39,42,0,0,0,0,0
2022-08-31T08:00,65,63,39,46,0,0,0,0,0
2022-08-31T09:00,64.7,49,32,33,0,0,0,0,0
2022-08-31T10:00,64.2,84,28,98,0,0,0,0,0
2022-08-31T11:00,63.8,43,9,53,11,6,2,4,0
2022-08-31T12:00,64.5,26,3,13,51,97,60,37,190.9
2022-08-31T13:00,66.1,14,4,9,16,283,216,67,479.4
2022-08-31T14:00,68.1,10,2,14,0,429,331,98,625.1
2022-08-31T15:00,70.4,27,5,37,0,539,417,122,630.5
2022-08-31T16:00,72.4,43,12,54,0,628,459,169,617.3
2022-08-31T17:00,73.3,42,9,57,0,622,442,180,573.4
2022-08-31T18:00,74.3,37,3,57,0,555,386,169,502.8
2022-08-31T19:00,75,25,2,38,0,505,372,133,473.8
2022-08-31T20:00,75.1,24,0,40,0,415,278,137,439.3
2022-08-31T21:00,75.6,25,2,39,0,378,266,112,434.1
2022-08-31T22:00,75,33,1,53,0,298,221,77,528.3
2022-08-31T23:00,72.9,31,1,50,0,122,84,38,492.6
2022-09-01T00:00,70.8,15,0,25,0,17,8,9,136.3
2022-09-01T01:00,70.1,14,0,24,0,0,0,0,0
2022-09-01T02:00,69.1,18,1,28,0,0,0,0,0
2022-09-01T03:00,68.7,20,6,25,0,0,0,0,0
2022-09-01T04:00,67.9,40,9,53,0,0,0,0,0
2022-09-01T05:00,66.9,50,24,47,0,0,0,0,0
2022-09-01T06:00,66.6,26,15,21,0,0,0,0,0
2022-09-01T07:00,66.2,12,8,8,0,0,0,0,0
2022-09-01T08:00,65.6,5,5,1,0,0,0,0,0
2022-09-01T09:00,64.2,2,2,0,0,0,0,0,0
2022-09-01T10:00,63,15,10,2,16,0,0,0,0
2022-09-01T11:00,61.9,17,11,6,13,6,2,4,0
2022-09-01T12:00,62.1,38,19,4,60,103,62,41,208.9
2022-09-01T13:00,62.9,78,61,1,76,245,157,88,404.6
2022-09-01T14:00,64.4,77,65,0,62,425,318,107,535.2
2022-09-01T15:00,65.7,90,83,0,51,419,252,167,499
2022-09-01T16:00,67.2,60,65,0,6,581,366,215,420.1
2022-09-01T17:00,68.5,44,49,0,0,634,408,226,491.5
2022-09-01T18:00,69.8,16,18,0,0,729,488,241,542.5
2022-09-01T19:00,70.8,0,0,0,0,754,576,178,667.5
2022-09-01T20:00,71.2,0,0,0,0,685,596,89,815.5
2022-09-01T21:00,70.7,0,0,0,0,535,455,80,858.4
2022-09-01T22:00,69.5,0,0,0,0,350,281,69,778.8
2022-09-01T23:00,67.3,0,0,0,0,160,113,47,643.9
2022-09-02T00:00,64.5,0,0,0,0,20,10,10,177.8
2022-09-02T01:00,62.2,0,0,0,0,0,0,0,0
2022-09-02T02:00,60.7,0,0,0,0,0,0,0,0
2022-09-02T03:00,60.4,0,0,0,0,0,0,0,0
2022-09-02T04:00,59.3,0,0,0,0,0,0,0,0
2022-09-02T05:00,58.1,0,0,0,0,0,0,0,0
2022-09-02T06:00,57.5,0,0,0,0,0,0,0,0
2022-09-02T07:00,56.9,0,0,0,0,0,0,0,0
2022-09-02T08:00,56.7,0,0,0,0,0,0,0,0
2022-09-02T09:00,56.3,0,0,0,0,0,0,0,0
2022-09-02T10:00,55.8,0,0,0,0,0,0,0,0
2022-09-02T11:00,55.5,0,0,0,0,6,2,4,0
2022-09-02T12:00,58.2,0,0,0,0,116,77,39,251.9
2022-09-02T13:00,63,0,0,0,0,299,234,65,568.2
2022-09-02T14:00,67.1,0,0,0,0,483,403,80,722.9
2022-09-02T15:00,70.5,0,0,0,0,640,552,88,809.3
2022-09-02T16:00,73.6,0,0,0,1,755,661,94,857.7
2022-09-02T17:00,76.1,3,2,0,4,819,722,97,883.3
2022-09-02T18:00,78,6,0,0,21,825,726,99,893
2022-09-02T19:00,79.1,7,0,0,24,764,659,105,874
2022-09-02T20:00,79.7,2,0,0,8,664,574,90,851.6
2022-09-02T21:00,79.5,2,0,0,7,515,433,82,822
2022-09-02T22:00,78.2,3,0,0,11,338,271,67,755.4
2022-09-02T23:00,75.6,9,0,0,29,148,97,51,602.9
2022-09-03T00:00,72.3,10,0,0,33,17,8,9,143.7
2022-09-03T01:00,70.1,4,0,0,12,0,0,0,0
2022-09-03T02:00,68.2,25,0,0,82,0,0,0,0
2022-09-03T03:00,66.8,30,0,0,100,0,0,0,0
2022-09-03T04:00,65.8,30,0,0,99,0,0,0,0
2022-09-03T05:00,65.3,28,0,0,93,0,0,0,0
2022-09-03T06:00,65,29,0,0,97,0,0,0,0
2022-09-03T07:00,64.2,26,1,0,83,0,0,0,0
2022-09-03T08:00,64.2,26,15,4,33,0,0,0,0
2022-09-03T09:00,64.2,45,21,11,66,0,0,0,0
2022-09-03T10:00,64.3,100,68,33,97,0,0,0,0
2022-09-03T11:00,64.8,100,62,37,100,3,0,3,0
2022-09-03T12:00,66.2,82,36,36,94,53,11,42,27
2022-09-03T13:00,69.1,69,20,35,100,186,70,116,130.6
2022-09-03T14:00,72.4,58,13,27,100,318,153,165,245.1
2022-09-03T15:00,76,47,8,16,100,509,309,200,381.1
2022-09-03T16:00,79,39,14,9,70,657,449,208,538.4
2022-09-03T17:00,81.2,32,9,25,31,675,514,161,622.8
2022-09-03T18:00,82.4,64,25,37,63,595,485,110,627.6
2022-09-03T19:00,83.5,55,21,39,43,493,310,183,507
2022-09-03T20:00,82.4,59,29,26,59,328,181,147,329.9
2022-09-03T21:00,81.9,62,25,30,71,274,143,131,257.9
2022-09-03T22:00,80.7,48,2,35,85,231,122,109,296.7
2022-09-03T23:00,78.4,53,4,48,70,100,40,60,271.4
2022-09-04T00:00,75.6,50,11,49,36,11,3,8,55.5
2022-09-04T01:00,74.3,34,14,27,18,0,0,0,0
2022-09-04T02:00,73.1,50,19,52,4,0,0,0,0
2022-09-04T03:00,72.2,36,12,41,3,0,0,0,0
2022-09-04T04:00,71,27,5,37,0,0,0,0,0
2022-09-04T05:00,70.2,29,10,32,1,0,0,0,0
2022-09-04T06:00,69.4,26,17,16,3,0,0,0,0
2022-09-04T07:00,69.1,26,21,10,4,0,0,0,0
2022-09-04T08:00,68.4,29,17,13,19,0,0,0,0
2022-09-04T09:00,67.9,43,18,17,56,0,0,0,0
2022-09-04T10:00,67.3,54,14,28,83,0,0,0,0
2022-09-04T11:00,67.1,56,9,32,96,2,0,2,0
2022-09-04T12:00,68.3,52,10,26,90,64,18,46,52.5
2022-09-04T13:00,70.5,81,20,57,95,167,53,114,138.2
2022-09-04T14:00,72.9,100,60,37,98,220,50,170,128
2022-09-04T15:00,73.8,100,78,42,99,205,49,156,83.6
2022-09-04T16:00,75.2,100,100,43,100,312,68,244,81.7
2022-09-04T17:00,77,100,99,44,100,355,76,279,90.3
2022-09-04T18:00,78.3,100,100,45,100,385,130,255,132.4
2022-09-04T19:00,74.5,100,83,56,100,255,31,224,106.3
2022-09-04T20:00,73.9,100,75,55,100,185,0,185,15.2
2022-09-04T21:00,73.8,100,77,73,100,146,6,140,3.3
2022-09-04T22:00,73.2,100,64,71,99,84,11,73,21.7
2022-09-04T23:00,72.1,100,62,63,100,34,0,34,15.6
2022-09-05T00:00,71,100,66,92,100,3,0,3,0
2022-09-05T01:00,69.7,100,67,100,100,0,0,0,0
2022-09-05T02:00,69.1,100,60,100,100,0,0,0,0
2022-09-05T03:00,68.3,100,47,100,100,0,0,0,0
2022-09-05T04:00,67.8,94,6,98,100,0,0,0,0
2022-09-05T05:00,67.5,100,24,97,100,0,0,0,0
2022-09-05T06:00,67.4,100,36,100,100,0,0,0,0
2022-09-05T07:00,67.3,100,17,99,100,0,0,0,0
2022-09-05T08:00,67.1,100,19,94,100,0,0,0,0
2022-09-05T09:00,67.1,100,82,100,100,0,0,0,0
2022-09-05T10:00,67,100,81,99,100,0,0,0,0
2022-09-05T11:00,67.1,100,61,99,100,1,0,1,0
2022-09-05T12:00,67.5,100,38,100,100,20,0,20,0
2022-09-05T13:00,68,100,38,98,100,25,0,25,0
2022-09-05T14:00,68.7,100,53,100,100,63,0,63,0
2022-09-05T15:00,69.3,100,68,100,100,71,0,71,0
2022-09-05T16:00,69.5,100,85,100,100,80,0,80,0
2022-09-05T17:00,69.8,100,89,97,100,91,2,89,1.3
2022-09-05T18:00,70.1,100,87,99,100,53,0,53,1.4
2022-09-05T19:00,70.3,100,71,99,100,87,0,87,0
2022-09-05T20:00,70.5,100,94,97,100,78,6,72,4.7
2022-09-05T21:00,70.3,100,88,93,100,90,0,90,4.8
2022-09-05T22:00,70,100,99,80,100,56,0,56,0
2022-09-05T23:00,69.4,100,93,37,100,29,0,29,0
2022-09-06T00:00,68.7,100,100,36,100,3,0,3,0
2022-09-06T01:00,68,100,100,46,100,0,0,0,0
2022-09-06T02:00,67.4,100,92,30,100,0,0,0,0
2022-09-06T03:00,66.6,100,100,29,100,0,0,0,0
2022-09-06T04:00,66.3,100,97,34,100,0,0,0,0
2022-09-06T05:00,66,100,86,29,100,0,0,0,0
2022-09-06T06:00,65.9,100,88,12,100,0,0,0,0
2022-09-06T07:00,66.5,100,92,9,100,0,0,0,0
2022-09-06T08:00,66.6,100,99,0,100,0,0,0,0
2022-09-06T09:00,66.5,100,100,5,100,0,0,0,0
2022-09-06T10:00,66.3,100,100,30,95,0,0,0,0
2022-09-06T11:00,66.2,100,100,28,96,1,0,1,0
2022-09-06T12:00,66.2,100,100,22,92,16,0,16,0
2022-09-06T13:00,66.5,100,100,15,34,47,0,47,0
2022-09-06T14:00,66.7,100,100,24,41,78,1,77,0.9
2022-09-06T15:00,67.5,100,100,17,61,113,1,112,0.7
2022-09-06T16:00,68.5,100,100,7,73,170,22,148,16.4
2022-09-06T17:00,69.3,100,100,4,85,163,2,161,17
2022-09-06T18:00,70.1,100,100,1,83,195,11,184,1.7
2022-09-06T19:00,71.5,100,100,0,80,250,120,130,86.6
2022-09-06T20:00,71.9,100,100,5,72,244,92,152,160.9
2022-09-06T21:00,69.8,100,100,8,76,121,5,116,71.8
2022-09-06T22:00,69.1,100,100,11,50,88,28,60,40.2
2022-09-06T23:00,68.3,100,100,21,42,28,1,27,45.1
2022-09-07T00:00,67.5,100,100,33,28,2,0,2,0
2022-09-07T01:00,67,100,100,60,30,0,0,0,0
2022-09-07T02:00,66.6,100,100,76,30,0,0,0,0
2022-09-07T03:00,66.3,100,100,88,20,0,0,0,0
2022-09-07T04:00,65.8,100,100,99,8,0,0,0,0
2022-09-07T05:00,65.6,100,100,97,3,0,0,0,0
2022-09-07T06:00,65.3,100,100,88,4,0,0,0,0
2022-09-07T07:00,65.6,100,100,86,4,0,0,0,0
2022-09-07T08:00,65.5,100,100,89,6,0,0,0,0
2022-09-07T09:00,65.1,100,100,100,1,0,0,0,0
2022-09-07T10:00,64.8,100,100,84,19,0,0,0,0
2022-09-07T11:00,64.7,100,100,87,42,0,0,0,0
2022-09-07T12:00,64.5,100,100,88,50,8,0,8,0
2022-09-07T13:00,64.8,100,100,89,34,28,0,28,0
2022-09-07T14:00,64.9,100,100,93,27,31,0,31,0
2022-09-07T15:00,65.3,100,100,100,23,50,0,50,0
2022-09-07T16:00,66,100,100,97,17,126,10,116,7.2
2022-09-07T17:00,66,100,100,100,16,95,0,95,7.4
2022-09-07T18:00,66.5,100,97,100,21,114,0,114,0
2022-09-07T19:00,67.2,100,91,95,16,109,19,90,13.6
2022-09-07T20:00,66.7,100,92,85,9,54,0,54,14
2022-09-07T21:00,66.8,100,87,74,1,93,0,93,0
2022-09-07T22:00,67.1,100,70,64,1,87,6,81,7.1
2022-09-07T23:00,66.6,100,95,54,0,33,7,26,30.9
2022-09-08T00:00,66,100,100,92,0,3,0,3,7.4
2022-09-08T01:00,65.6,100,100,96,0,0,0,0,0
2022-09-08T02:00,65.3,100,100,93,0,0,0,0,0
2022-09-08T03:00,65.7,100,100,85,0,0,0,0,0
2022-09-08T04:00,65.2,100,100,70,0,0,0,0,0
2022-09-08T05:00,64.7,100,100,58,0,0,0,0,0
2022-09-08T06:00,64.8,100,93,50,0,0,0,0,0
2022-09-08T07:00,65.5,100,94,54,0,0,0,0,0
2022-09-08T08:00,63.8,100,90,48,0,0,0,0,0
2022-09-08T09:00,63,100,95,52,0,0,0,0,0
2022-09-08T10:00,63,100,97,57,0,0,0,0,0
2022-09-08T11:00,63.1,100,95,54,0,1,0,1,0
2022-09-08T12:00,64.5,100,90,59,0,33,9,24,25.7
2022-09-08T13:00,64.9,100,98,61,0,106,49,57,106.3
2022-09-08T14:00,66.6,100,98,36,0,160,58,102,128.9
2022-09-08T15:00,68.6,79,66,32,0,318,165,153,184.1
2022-09-08T16:00,70.1,91,93,12,0,387,197,190,266.6
2022-09-08T17:00,71.5,80,74,22,0,445,252,193,295.4
2022-09-08T18:00,72.9,78,73,20,0,452,216,236,295.2
2022-09-08T19:00,74.3,65,63,14,0,470,267,203,309.7
2022-09-08T20:00,73.8,43,33,22,0,438,287,151,401.3
2022-09-08T21:00,73.5,53,41,27,0,343,243,100,462.4
2022-09-08T22:00,72.3,60,23,66,0,202,128,74,422.7
2022-09-08T23:00,70.5,41,13,48,0,75,39,36,297.4
2022-09-09T00:00,69.4,15,12,7,0,6,2,4,36.4
2022-09-09T01:00,68.5,8,8,2,0,0,0,0,0
2022-09-09T02:00,67.6,11,9,4,0,0,0,0,0
2022-09-09T03:00,66.5,8,7,2,0,0,0,0,0
2022-09-09T04:00,66.2,3,3,0,0,0,0,0,0
2022-09-09T05:00,66.3,23,26,0,0,0,0,0,0
2022-09-09T06:00,65.3,91,100,1,0,0,0,0,0
2022-09-09T07:00,62.1,90,100,0,0,0,0,0,0
2022-09-09T08:00,62.7,90,100,0,0,0,0,0,0
2022-09-09T09:00,63,90,100,0,0,0,0,0,0
2022-09-09T10:00,63,90,100,0,0,0,0,0,0
2022-09-09T11:00,62.4,90,100,0,0,1,0,1,0
2022-09-09T12:00,62.7,90,100,0,0,46,5,41,16.2
2022-09-09T13:00,64.5,88,98,0,0,149,15,134,29.8
2022-09-09T14:00,67.5,69,77,0,0,330,154,176,164.8
2022-09-09T15:00,72,23,25,0,0,543,359,184,435.9
2022-09-09T16:00,75.6,0,0,0,0,711,592,119,692.3
2022-09-09T17:00,78.1,3,3,0,0,789,690,99,856.7
2022-09-09T18:00,79.4,16,18,0,0,756,623,133,843.3
2022-09-09T19:00,80,10,11,0,0,667,509,158,737.1
2022-09-09T20:00,80,11,10,3,0,569,437,132,677.2
2022-09-09T21:00,79.5,4,0,7,0,453,350,103,681.1
2022-09-09T22:00,77.9,1,0,1,0,288,214,74,654.2
2022-09-09T23:00,75.9,0,0,0,0,119,79,40,555.9
2022-09-10T00:00,73.6,0,0,0,0,7,3,4,66.4
2022-09-10T01:00,71.9,0,0,0,0,0,0,0,0
2022-09-10T02:00,70.2,0,0,0,0,0,0,0,0
2022-09-10T03:00,69.2,0,0,0,0,0,0,0,0
2022-09-10T04:00,68,0,0,0,0,0,0,0,0
2022-09-10T05:00,66.9,0,0,0,0,0,0,0,0
2022-09-10T06:00,66.2,0,0,0,0,0,0,0,0
2022-09-10T07:00,64.8,0,0,0,0,0,0,0,0
2022-09-10T08:00,64.3,0,0,0,0,0,0,0,0
2022-09-10T09:00,63.9,0,0,0,0,0,0,0,0
2022-09-10T10:00,63.6,0,0,0,0,0,0,0,0
2022-09-10T11:00,63,1,0,0,3,2,1,1,0
2022-09-10T12:00,64.2,1,0,0,2,95,61,34,231.7
2022-09-10T13:00,68.7,4,0,0,14,276,215,61,548.5
2022-09-10T14:00,72.5,8,0,0,25,460,383,77,719.9
2022-09-10T15:00,75.6,3,0,0,9,619,533,86,812.7
2022-09-10T16:00,77.7,27,0,0,90,729,623,106,853.4
2022-09-10T17:00,79.1,29,0,0,96,779,636,143,836.8
2022-09-10T18:00,80,25,0,0,82,769,607,162,788.5
2022-09-10T19:00,80.2,30,0,0,100,752,656,96,840.8
2022-09-10T20:00,80,30,0,0,100,591,418,173,796.9
2022-09-10T21:00,78.1,30,0,0,100,327,102,225,423.6
2022-09-10T22:00,75.9,30,0,0,100,179,36,143,138.3
2022-09-10T23:00,73.6,30,0,0,100,65,3,62,59
2022-09-11T00:00,71.5,34,0,8,97,3,0,3,1.7
2022-09-11T01:00,70.1,56,0,43,100,0,0,0,0
2022-09-11T02:00,69.2,82,0,86,100,0,0,0,0
2022-09-11T03:00,68.4,88,0,97,100,0,0,0,0
2022-09-11T04:00,67.6,89,0,99,100,0,0,0,0
2022-09-11T05:00,67.4,88,0,97,100,0,0,0,0
2022-09-11T06:00,67.1,85,0,92,99,0,0,0,0
2022-09-11T07:00,66.7,75,0,75,100,0,0,0,0
2022-09-11T08:00,66.6,65,0,59,100,0,0,0,0
2022-09-11T09:00,66.3,65,0,59,99,0,0,0,0
2022-09-11T10:00,65.7,79,0,81,100,0,0,0,0
2022-09-11T11:00,65.4,89,1,96,100,1,0,1,0
2022-09-11T12:00,65.9,99,10,100,100,48,4,44,13.3
2022-09-11T13:00,67.7,95,6,100,100,134,12,122,32.9
2022-09-11T14:00,69.1,100,36,100,100,178,30,148,51.6
2022-09-11T15:00,69.7,100,58,100,100,131,0,131,31.8
2022-09-11T16:00,70.2,100,81,100,99,163,4,159,1.4
2022-09-11T17:00,70,100,92,100,100,169,5,164,6.2
2022-09-11T18:00,70.2,100,52,100,100,191,5,186,6.4
2022-09-11T19:00,68,100,61,100,100,108,0,108,3.2
2022-09-11T20:00,68,100,99,100,100,77,0,77,0
2022-09-11T21:00,68.5,100,85,98,100,79,1,78,1.2
2022-09-11T22:00,68.4,100,99,99,70,54,0,54,1
2022-09-11T23:00,67.8,100,97,97,58,22,0,22,0
2022-09-12T00:00,67.3,100,99,80,96,1,0,1,0
2022-09-12T01:00,66.6,100,97,29,77,0,0,0,0
2022-09-12T02:00,66.3,100,100,51,36,0,0,0,0
2022-09-12T03:00,65.8,100,100,47,57,0,0,0,0
2022-09-12T04:00,65.6,100,100,64,48,0,0,0,0
2022-09-12T05:00,65.3,100,98,53,20,0,0,0,0
2022-09-12T06:00,65.1,100,88,40,9,0,0,0,0
2022-09-12T07:00,65.9,100,95,33,0,0,0,0,0
2022-09-12T08:00,66.1,100,82,49,14,0,0,0,0
2022-09-12T09:00,66,100,60,60,76,0,0,0,0
2022-09-12T10:00,65.8,100,94,58,17,0,0,0,0
2022-09-12T11:00,65.8,100,100,69,42,0,0,0,0
2022-09-12T12:00,66.4,100,100,72,66,18,1,17,2.8
2022-09-12T13:00,67,100,95,73,71,53,4,49,10.3
2022-09-12T14:00,68.9,100,100,61,62,120,6,114,10.8
2022-09-12T15:00,71,100,94,43,14,190,28,162,26.3
2022-09-12T16:00,73.1,100,78,37,52,254,66,188,66
2022-09-12T17:00,75.2,90,56,43,46,377,129,248,130.5
2022-09-12T18:00,76.5,57,28,40,25,379,130,249,156.2
2022-09-12T19:00,78.9,35,25,15,10,517,372,145,340.7
2022-09-12T20:00,79.2,100,63,92,11,435,268,167,484.9
2022-09-12T21:00,75.7,54,19,32,60,307,188,119,404.9
2022-09-12T22:00,72.9,49,18,18,72,158,66,92,287.7
2022-09-12T23:00,72,46,23,9,65,63,29,34,191
2022-09-13T00:00,71.1,78,65,11,42,2,0,2,16
2022-09-13T01:00,70.2,63,47,19,30,0,0,0,0
2022-09-13T02:00,69.7,74,59,18,33,0,0,0,0
2022-09-13T03:00,67.8,100,92,35,26,0,0,0,0
2022-09-13T04:00,67.4,75,54,26,36,0,0,0,0
2022-09-13T05:00,67.2,87,53,35,60,0,0,0,0
2022-09-13T06:00,66.7,77,51,24,54,0,0,0,0
2022-09-13T07:00,65.9,100,67,35,65,0,0,0,0
2022-09-13T08:00,66,100,100,59,59,0,0,0,0
2022-09-13T09:00,64.4,100,100,49,52,0,0,0,0
2022-09-13T10:00,64.4,100,95,27,47,0,0,0,0
2022-09-13T11:00,63.9,100,100,99,9,0,0,0,0
2022-09-13T12:00,63.1,100,100,94,1,28,15,13,59.3
2022-09-13T13:00,62.5,100,100,61,0,68,0,68,62
2022-09-13T14:00,62.2,100,100,30,0,80,0,80,0
2022-09-13T15:00,62.5,100,98,30,0,113,0,113,0
2022-09-13T16:00,62.7,92,91,16,0,158,19,139,7.7
2022-09-13T17:00,63.9,59,51,21,0,282,118,164,86.6
2022-09-13T18:00,65.1,39,25,25,5,329,181,148,184.1
2022-09-13T19:00,70.2,44,22,32,17,547,424,123,414.4
2022-09-13T20:00,69.3,41,19,31,17,460,325,135,566.6
2022-09-13T21:00,69.3,55,19,40,47,390,271,119,540
2022-09-13T22:00,67.6,60,26,31,59,203,109,94,450.4
2022-09-13T23:00,65.5,42,20,34,13,71,28,43,255.6
2022-09-14T00:00,64.6,32,16,27,4,2,0,2,13.1
2022-09-14T01:00,63.5,30,13,30,0,0,0,0,0
2022-09-14T02:00,62.5,27,14,24,0,0,0,0,0
2022-09-14T03:00,61.3,21,11,19,0,0,0,0,0
2022-09-14T04:00,60.3,12,9,7,0,0,0,0,0
2022-09-14T05:00,59.5,2,2,1,0,0,0,0,0
2022-09-14T06:00,59.2,2,1,1,0,0,0,0,0
2022-09-14T07:00,59.3,2,2,0,0,0,0,0,0
2022-09-14T08:00,59.4,0,0,0,0,0,0,0,0
2022-09-14T09:00,59.4,1,1,0,0,0,0,0,0
2022-09-14T10:00,59.2,0,0,0,0,0,0,0,0
2022-09-14T11:00,59,1,1,0,0,1,0,1,0
2022-09-14T12:00,60.4,9,10,0,0,79,50,29,185.7
2022-09-14T13:00,63.5,29,32,1,0,206,133,73,429.6
2022-09-14T14:00,65.7,61,68,0,0,226,91,135,310.5
2022-09-14T15:00,67.8,64,69,3,0,315,98,217,167.2
2022-09-14T16:00,68.9,63,53,26,0,277,66,211,120.5
2022-09-14T17:00,70,43,30,27,0,380,152,228,131.7
2022-09-14T18:00,71.9,62,39,44,0,517,340,177,316.6
2022-09-14T19:00,74.7,42,24,34,0,591,441,150,543.1
2022-09-14T20:00,74.8,62,37,48,0,439,307,132,562.7
2022-09-14T21:00,73.8,42,27,30,0,324,235,89,486.2
2022-09-14T22:00,71.8,41,27,27,0,189,128,61,444.6
2022-09-14T23:00,69.6,37,30,16,0,70,40,30,336.3
2022-09-15T00:00,67.7,30,29,7,0,2,0,2,14.6
2022-09-15T01:00,65.7,37,32,13,0,0,0,0,0
2022-09-15T02:00,64,66,56,26,0,0,0,0,0
2022-09-15T03:00,62.8,76,77,12,0,0,0,0,0
2022-09-15T04:00,62.1,76,81,5,0,0,0,0,0
2022-09-15T05:00,61.8,53,59,0,0,0,0,0,0
2022-09-15T06:00,61.2,39,43,0,0,0,0,0,0
2022-09-15T07:00,58.9,29,32,0,0,0,0,0,0
2022-09-15T08:00,57.4,39,43,0,0,0,0,0,0
2022-09-15T09:00,56.2,41,46,0,0,0,0,0,0
2022-09-15T10:00,55.1,40,44,0,0,0,0,0,0
2022-09-15T11:00,54.3,39,43,0,0,1,0,1,0
2022-09-15T12:00,54.3,35,39,0,0,66,31,35,108.1
2022-09-15T13:00,55.4,22,24,0,0,241,157,84,374.8
2022-09-15T14:00,56.9,58,64,0,0,436,332,104,604.6
2022-09-15T15:00,59,55,61,0,0,601,484,117,745.4
2022-09-15T16:00,61.1,50,55,0,0,727,616,111,829.1
2022-09-15T17:00,62.8,32,36,0,0,793,692,101,890.9
2022-09-15T18:00,64,19,21,0,0,796,699,97,918.5
2022-09-15T19:00,64,1,1,0,0,720,602,118,883.8
2022-09-15T20:00,64,0,0,0,0,603,501,102,825.8
2022-09-15T21:00,63.2,0,0,0,0,465,387,78,810.8
2022-09-15T22:00,61.9,0,0,0,0,278,216,62,752.4
2022-09-15T23:00,59.8,0,0,0,0,94,61,33,553.3
2022-09-16T00:00,57.9,0,0,0,0,2,0,2,18
2022-09-16T01:00,55.8,0,0,0,0,0,0,0,0
2022-09-16T02:00,55,1,0,0,4,0,0,0,0
2022-09-16T03:00,55.9,7,0,0,22,0,0,0,0
2022-09-16T04:00,52.8,5,0,0,18,0,0,0,0
2022-09-16T05:00,51.9,1,0,0,3,0,0,0,0
2022-09-16T06:00,54.1,0,0,0,0,0,0,0,0
2022-09-16T07:00,51.8,0,0,0,0,0,0,0,0
2022-09-16T08:00,50.4,0,0,0,0,0,0,0,0
2022-09-16T09:00,50.3,2,0,0,5,0,0,0,0
2022-09-16T10:00,49.6,8,0,0,26,0,0,0,0
2022-09-16T11:00,49.5,13,0,1,41,1,0,1,0
2022-09-16T12:00,52.5,13,0,1,42,80,49,31,0
2022-09-16T13:00,57.7,24,10,13,24,237,167,70,467.1
2022-09-16T14:00,62.1,27,10,12,37,378,279,99,568.4
2022-09-16T15:00,64.9,26,4,19,38,527,391,136,616.1
2022-09-16T16:00,67,15,1,14,18,614,450,164,637.9
2022-09-16T17:00,69.1,56,41,16,31,699,537,162,679.5
2022-09-16T18:00,70.4,100,87,52,44,590,411,179,639.3
2022-09-16T19:00,70.8,100,94,60,24,417,240,177,445.1
2022-09-16T20:00,70.2,100,96,26,73,296,70,226,222.6
2022-09-16T21:00,69,100,92,51,92,164,27,137,77.3
2022-09-16T22:00,67.4,100,82,40,90,105,12,93,44.4
2022-09-16T23:00,65,100,70,24,91,38,8,30,46.7
2022-09-17T00:00,63.8,86,57,22,73,1,0,1,1.9
2022-09-17T01:00,63.2,85,62,20,58,0,0,0,0
2022-09-17T02:00,62.7,89,63,20,69,0,0,0,0
2022-09-17T03:00,62,92,66,11,88,0,0,0,0
2022-09-17T04:00,61.6,100,87,10,85,0,0,0,0
2022-09-17T05:00,61.7,100,96,30,95,0,0,0,0
2022-09-17T06:00,61.3,100,82,27,97,0,0,0,0
2022-09-17T07:00,61.5,100,69,27,84,0,0,0,0
2022-09-17T08:00,61.4,82,64,20,42,0,0,0,0
2022-09-17T09:00,61.1,44,42,8,5,0,0,0,0
2022-09-17T10:00,60.4,41,43,2,2,0,0,0,0
2022-09-17T11:00,59.5,55,52,3,21,0,0,0,0
2022-09-17T12:00,60.8,44,42,4,12,64,35,29,0
2022-09-17T13:00,65,19,18,0,9,222,150,72,387.9
2022-09-17T14:00,68.8,26,28,0,4,362,268,94,530.5
2022-09-17T15:00,72.9,22,15,0,27,561,461,100,664.3
2022-09-17T16:00,76,16,6,0,35,674,566,108,789.5
2022-09-17T17:00,77.9,32,30,0,15,725,621,104,815.5
2022-09-17T18:00,79.2,24,27,0,0,749,650,99,855.9
2022-09-17T19:00,79.8,20,20,3,2,590,423,167,739.3
2022-09-17T20:00,79.9,18,17,4,2,473,326,147,558.2
2022-09-17T21:00,79.1,19,13,9,6,373,261,112,545
2022-09-17T22:00,77.3,11,5,5,10,216,150,66,527.7
2022-09-17T23:00,74,9,8,1,5,77,47,30,395.1
2022-09-18T00:00,71.1,13,12,0,9,1,0,1,7.5
2022-09-18T01:00,69.8,23,13,2,35,0,0,0,0
2022-09-18T02:00,69.1,13,6,10,5,0,0,0,0
2022-09-18T03:00,68.1,18,9,12,10,0,0,0,0
2022-09-18T04:00,67.6,21,9,21,1,0,0,0,0
2022-09-18T05:00,67.6,32,10,28,22,0,0,0,0
2022-09-18T06:00,67.4,44,10,29,58,0,0,0,0
2022-09-18T07:00,66.6,26,5,15,43,0,0,0,0
2022-09-18T08:00,66.3,24,3,19,34,0,0,0,0
2022-09-18T09:00,66,24,7,15,28,0,0,0,0
2022-09-18T10:00,65.8,69,42,27,51,0,0,0,0
2022-09-18T11:00,65.7,60,32,26,51,0,0,0,0
2022-09-18T12:00,66.7,65,25,34,72,55,31,24,0
2022-09-18T13:00,70.3,55,18,36,57,205,144,61,368.7
2022-09-18T14:00,73.7,55,5,35,98,330,245,85,506.5
2022-09-18T15:00,76.9,55,5,36,97,475,357,118,566
2022-09-18T16:00,78.3,45,2,22,99,448,307,141,518.3
2022-09-18T17:00,79.3,69,15,42,100,512,356,156,445.9
2022-09-18T18:00,80.1,75,22,43,99,584,447,137,539
2022-09-18T19:00,80.8,68,14,43,97,527,387,140,592.9
2022-09-18T20:00,76,56,8,45,71,299,167,132,421.2
2022-09-18T21:00,75.6,80,23,54,89,212,74,138,207.1
2022-09-18T22:00,74.5,55,0,41,100,115,50,65,160
2022-09-18T23:00,73.1,89,5,97,88,34,13,21,125.1
2022-09-19T00:00,72,83,8,98,56,0,0,0,1.3
2022-09-19T01:00,71.1,68,0,94,38,0,0,0,0
2022-09-19T02:00,70.2,90,15,100,54,0,0,0,0
2022-09-19T03:00,70.1,100,67,98,71,0,0,0,0
2022-09-19T04:00,69.9,100,93,95,77,0,0,0,0
2022-09-19T05:00,69.5,100,62,95,66,0,0,0,0
2022-09-19T06:00,68.8,77,23,66,54,0,0,0,0
2022-09-19T07:00,68.6,56,21,53,19,0,0,0,0
2022-09-19T08:00,68.2,58,36,32,20,0,0,0,0
2022-09-19T09:00,67.6,51,27,35,18,0,0,0,0
2022-09-19T10:00,66.6,77,52,36,30,0,0,0,0
2022-09-19T11:00,66.2,100,71,65,65,0,0,0,0
2022-09-19T12:00,66.8,71,30,43,61,34,11,23,0
2022-09-19T13:00,68.1,70,12,52,94,115,33,82,100.5
2022-09-19T14:00,69.5,97,9,98,99,238,91,147,157.2
2022-09-19T15:00,69.9,100,20,100,100,214,64,150,159.3
2022-09-19T16:00,70.2,100,65,100,100,180,17,163,59.1
2022-09-19T17:00,70.2,100,78,98,100,303,83,220,63
2022-09-19T18:00,71.5,78,9,66,100,352,99,253,131
2022-09-19T19:00,68.6,47,17,4,99,145,6,139,71.4
2022-09-19T20:00,68.2,60,55,1,34,189,27,162,19.6
2022-09-19T21:00,68.9,59,60,7,2,169,41,128,70.4
2022-09-19T22:00,68.4,62,16,41,76,61,12,49,68.7
2022-09-19T23:00,68.1,41,7,24,66,18,0,18,18.1
2022-09-20T00:00,66.7,79,55,10,78,0,0,0,0
2022-09-20T01:00,65.8,95,91,9,25,0,0,0,0
2022-09-20T02:00,65.6,66,65,12,1,0,0,0,0
2022-09-20T03:00,64.8,48,42,17,0,0,0,0,0
2022-09-20T04:00,64.4,60,49,27,0,0,0,0,0
2022-09-20T05:00,63.9,33,34,2,4,0,0,0,0
2022-09-20T06:00,63,32,35,0,3,0,0,0,0
2022-09-20T07:00,62.9,31,32,2,2,0,0,0,0
2022-09-20T08:00,61.9,37,40,2,0,0,0,0,0
2022-09-20T09:00,61.1,67,70,6,0,0,0,0,0
2022-09-20T10:00,60.6,87,87,15,0,0,0,0,0
2022-09-20T11:00,60.4,69,61,24,0,0,0,0,0
2022-09-20T12:00,61.1,45,41,14,0,39,14,25,0
2022-09-20T13:00,62.1,39,39,7,0,72,14,58,89.3
2022-09-20T14:00,62.8,56,41,32,0,134,14,120,25.3
2022-09-20T15:00,64.4,74,30,79,0,332,169,163,153.5
2022-09-20T16:00,65.9,91,50,77,0,355,210,145,312
2022-09-20T17:00,66.2,95,44,92,0,275,89,186,219.3
2022-09-20T18:00,65.6,100,65,82,0,168,6,162,51.5
2022-09-20T19:00,69,100,73,82,4,297,109,188,73.9
2022-09-20T20:00,69.4,100,71,73,18,279,142,137,205
2022-09-20T21:00,69.3,100,77,47,58,233,106,127,240.2
2022-09-20T22:00,68.4,100,82,32,81,154,65,89,231.2
2022-09-20T23:00,66.7,78,62,9,56,42,17,25,163.5
2022-09-21T00:00,65.4,77,53,1,97,0,0,0,0.3
2022-09-21T01:00,64.1,36,24,1,46,0,0,0,0
2022-09-21T02:00,63,41,37,0,27,0,0,0,0
2022-09-21T03:00,61.5,41,45,0,3,0,0,0,0
2022-09-21T04:00,60.5,30,33,0,0,0,0,0,0
2022-09-21T05:00,60,22,24,0,0,0,0,0,0
2022-09-21T06:00,59,12,13,0,0,0,0,0,0
2022-09-21T07:00,59.3,5,6,0,0,0,0,0,0
2022-09-21T08:00,59,5,5,0,0,0,0,0,0
2022-09-21T09:00,58.7,4,4,0,0,0,0,0,0
2022-09-21T10:00,58.1,4,4,0,1,0,0,0,0
2022-09-21T11:00,57.5,17,16,0,7,0,0,0,0
2022-09-21T12:00,59.2,36,40,0,0,60,31,29,0
2022-09-21T13:00,63.9,0,0,0,0,216,137,79,369
2022-09-21T14:00,68.9,2,0,0,6,414,343,71,615.9
2022-09-21T15:00,72.6,9,0,0,31,554,452,102,771
2022-09-21T16:00,75.5,14,0,0,48,643,497,146,745.4
2022-09-21T17:00,77.5,28,0,0,94,694,523,171,716.1
2022-09-21T18:00,79.1,30,0,0,100,692,524,168,732.2
2022-09-21T19:00,79.3,43,6,12,100,470,159,311,479.5
2022-09-21T20:00,79.1,100,75,57,100,327,105,222,189.8
2022-09-21T21:00,77.3,53,13,21,95,184,42,142,130.9
2022-09-21T22:00,76.1,32,0,8,89,147,52,95,137.6
2022-09-21T23:00,74.2,38,0,24,80,42,10,32,123.6
2022-09-22T00:00,73,48,6,34,73,0,0,0,0
2022-09-22T01:00,71.7,26,15,7,26,0,0,0,0
2022-09-22T02:00,70.2,11,3,0,27,0,0,0,0
2022-09-22T03:00,69.3,57,24,9,99,0,0,0,0
2022-09-22T04:00,69.6,82,39,29,99,0,0,0,0
2022-09-22T05:00,69.3,100,83,16,71,0,0,0,0
2022-09-22T06:00,69.4,100,100,68,54,0,0,0,0
2022-09-22T07:00,67.6,100,100,92,41,0,0,0,0
2022-09-22T08:00,67.4,100,100,75,40,0,0,0,0
2022-09-22T09:00,64.9,100,98,78,36,0,0,0,0
2022-09-22T10:00,60.9,82,31,63,54,0,0,0,0
2022-09-22T11:00,59.2,62,1,75,52,0,0,0,0
2022-09-22T12:00,59,36,5,34,36,21,7,14,0
2022-09-22T13:00,59.5,46,6,63,8,148,88,60,184.1
2022-09-22T14:00,60.5,61,21,69,1,267,150,117,328.9
2022-09-22T15:00,60.7,44,21,41,0,310,190,120,321.9
2022-09-22T16:00,62,53,46,20,0,480,327,153,400.2
2022-09-22T17:00,62.3,88,81,25,0,529,340,189,473.1
2022-09-22T18:00,62.4,56,22,59,4,592,441,151,536.7
2022-09-22T19:00,59.2,95,60,69,0,489,353,136,578.3
2022-09-22T20:00,58.2,74,68,21,0,305,174,131,405.9
2022-09-22T21:00,57,84,49,67,0,263,158,105,319.1
2022-09-22T22:00,54.3,51,23,50,1,156,90,66,349.8
2022-09-22T23:00,53.4,47,21,47,1,32,14,18,196.5
2022-09-23T00:00,51.7,45,14,54,0,0,0,0,0
2022-09-23T01:00,50.8,69,24,79,0,0,0,0,0
2022-09-23T02:00,50.3,50,23,49,0,0,0,0,0
2022-09-23T03:00,49.5,74,40,64,0,0,0,0,0
2022-09-23T04:00,48.6,68,32,66,0,0,0,0,0
2022-09-23T05:00,48,57,40,35,0,0,0,0,0
2022-09-23T06:00,47.7,64,48,35,0,0,0,0,0
2022-09-23T07:00,47.6,56,42,30,0,0,0,0,0
2022-09-23T08:00,47.7,60,55,18,0,0,0,0,0
2022-09-23T09:00,47.7,82,70,32,0,0,0,0,0
2022-09-23T10:00,47.7,70,62,23,0,0,0,0,0
2022-09-23T11:00,47.8,75,83,1,0,0,0,0,0
2022-09-23T12:00,48.4,84,93,0,0,46,22,24,0
2022-09-23T13:00,49.2,90,100,0,0,187,98,89,280.1
2022-09-23T14:00,50.1,90,100,0,0,293,183,110,380.2
2022-09-23T15:00,51.4,90,100,0,0,427,251,176,426.5
2022-09-23T16:00,51.9,90,100,0,0,426,205,221,366
2022-09-23T17:00,52.6,90,100,0,0,500,256,244,325.5
2022-09-23T18:00,53.1,90,100,0,0,478,187,291,312.4
2022-09-23T19:00,51.1,90,100,0,0,361,103,258,202
2022-09-23T20:00,51.3,90,100,0,0,318,94,224,152.5
2022-09-23T21:00,51.6,90,100,0,0,256,83,173,178.9
2022-09-23T22:00,51.3,40,44,0,0,141,35,106,159.1
2022-09-23T23:00,50.9,18,20,0,0,41,14,27,100.8
2022-09-24T00:00,50.7,32,35,0,0,0,0,0,0
2022-09-24T01:00,49.9,45,50,0,0,0,0,0,0
2022-09-24T02:00,50,5,6,0,0,0,0,0,0
2022-09-24T03:00,50.2,3,3,0,0,0,0,0,0
2022-09-24T04:00,50.8,3,3,0,0,0,0,0,0
2022-09-24T05:00,50.4,10,11,0,0,0,0,0,0
2022-09-24T06:00,49.9,28,5,0,77,0,0,0,0
2022-09-24T07:00,48.3,26,3,0,79,0,0,0,0
2022-09-24T08:00,48.4,27,5,0,74,0,0,0,0
2022-09-24T09:00,48.2,26,9,0,58,0,0,0,0
2022-09-24T10:00,48.3,50,32,0,69,0,0,0,0
2022-09-24T11:00,48.4,50,26,0,88,0,0,0,0
2022-09-24T12:00,49.3,30,1,0,96,48,16,32,0
2022-09-24T13:00,52.2,30,1,0,96,182,74,108,208.7
2022-09-24T14:00,55,38,10,0,98,346,187,159,341.6
2022-09-24T15:00,57.1,58,35,0,89,481,285,196,460.1
2022-09-24T16:00,59.3,29,5,0,80,582,355,227,505.7
2022-09-24T17:00,61.2,21,2,0,65,664,487,177,599.1
2022-09-24T18:00,62.8,0,0,0,0,682,516,166,694.7
2022-09-24T19:00,63.6,0,0,0,0,674,588,86,802.4
2022-09-24T20:00,64,0,0,0,0,550,451,99,843.8
2022-09-24T21:00,63.7,0,0,0,0,404,332,72,780.8
2022-09-24T22:00,61.8,1,0,1,0,222,166,56,705.5
2022-09-24T23:00,60.3,5,1,4,4,52,30,22,371.9
2022-09-25T00:00,57.2,19,0,31,0,0,0,0,0
2022-09-25T01:00,58.5,58,0,95,4,0,0,0,0
2022-09-25T02:00,54.9,52,0,87,0,0,0,0,0
2022-09-25T03:00,54.5,29,0,48,0,0,0,0,0
2022-09-25T04:00,54.9,23,0,39,0,0,0,0,0
2022-09-25T05:00,54.6,32,2,49,3,0,0,0,0
2022-09-25T06:00,54.2,63,1,59,89,0,0,0,0
2022-09-25T07:00,54,83,2,88,96,0,0,0,0
2022-09-25T08:00,53.7,87,0,98,94,0,0,0,0
2022-09-25T09:00,53.9,79,6,87,72,0,0,0,0
2022-09-25T10:00,54,60,3,78,35,0,0,0,0
2022-09-25T11:00,54.2,77,3,85,79,0,0,0,0
2022-09-25T12:00,54.8,84,3,100,72,18,0,18,0
2022-09-25T13:00,56.1,93,4,100,99,94,9,85,11.8
2022-09-25T14:00,57.2,100,16,100,96,183,58,125,87.6
2022-09-25T15:00,56.1,70,8,70,68,119,4,115,73.5
2022-09-25T16:00,56.5,100,59,74,40,109,18,91,10.3
2022-09-25T17:00,59.2,100,73,78,39,230,41,189,40.5
2022-09-25T18:00,62.8,61,27,47,27,290,76,214,77.2
2022-09-25T19:00,65.4,73,24,51,69,309,155,154,178.1
2022-09-25T20:00,64.8,92,14,85,93,150,36,114,152.9
2022-09-25T21:00,62.4,96,29,73,87,143,52,91,89.2
2022-09-25T22:00,60.6,44,18,34,26,64,6,58,74.2
2022-09-25T23:00,59.5,46,17,26,49,18,4,14,18.7
2022-09-26T00:00,59.4,73,34,42,57,0,0,0,0
2022-09-26T01:00,58.6,57,31,29,40,0,0,0,0
2022-09-26T02:00,58.3,47,24,29,27,0,0,0,0
2022-09-26T03:00,57.7,62,40,38,10,0,0,0,0
2022-09-26T04:00,57.6,51,41,12,23,0,0,0,0
2022-09-26T05:00,57.6,68,55,21,19,0,0,0,0
2022-09-26T06:00,57.3,81,63,32,17,0,0,0,0
2022-09-26T07:00,57.4,70,39,56,3,0,0,0,0
2022-09-26T08:00,56.8,33,20,25,0,0,0,0,0
2022-09-26T09:00,56.4,10,8,4,0,0,0,0,0
2022-09-26T10:00,55.7,15,13,6,0,0,0,0,0
2022-09-26T11:00,54.9,33,33,4,4,0,0,0,0
2022-09-26T12:00,55.3,50,45,13,5,45,23,22,0
2022-09-26T13:00,56.6,58,30,50,3,163,80,83,273.3
2022-09-26T14:00,58.3,48,14,55,8,290,161,129,333.1
2022-09-26T15:00,60.2,34,2,36,35,300,182,118,340.5
2022-09-26T16:00,63,65,26,41,57,475,306,169,383.5
2022-09-26T17:00,61.8,73,22,65,46,556,369,187,497.5
2022-09-26T18:00,60.9,45,24,25,29,509,309,200,478.1
2022-09-26T19:00,63.8,32,13,19,28,479,309,170,448.3
2022-09-26T20:00,63.4,50,23,32,35,406,264,142,475.4
2022-09-26T21:00,62.2,85,35,56,65,272,163,109,437.2
2022-09-26T22:00,60.5,57,10,39,81,115,51,64,293.6
2022-09-26T23:00,58.3,43,1,32,75,28,10,18,109.4
2022-09-27T00:00,57.1,42,6,20,81,0,0,0,0
2022-09-27T01:00,56.1,31,2,23,51,0,0,0,0
2022-09-27T02:00,55.8,16,0,5,44,0,0,0,0
2022-09-27T03:00,55.5,21,6,4,45,0,0,0,0
2022-09-27T04:00,55.3,32,12,7,58,0,0,0,0
2022-09-27T05:00,55.8,76,60,6,62,0,0,0,0
2022-09-27T06:00,55.8,71,55,8,54,0,0,0,0
2022-09-27T07:00,56.3,84,56,43,27,0,0,0,0
2022-09-27T08:00,56.5,96,52,52,59,0,0,0,0
2022-09-27T09:00,56.3,80,44,43,48,0,0,0,0
2022-09-27T10:00,56,57,18,52,32,0,0,0,0
2022-09-27T11:00,55.5,41,17,34,16,0,0,0,0
2022-09-27T12:00,55.3,75,39,46,41,32,10,22,0
2022-09-27T13:00,56.6,83,49,42,44,130,47,83,141.1
2022-09-27T14:00,57.9,81,38,51,54,236,122,114,226.4
2022-09-27T15:00,59.7,78,39,44,55,371,198,173,318.9
2022-09-27T16:00,60.7,98,58,53,45,430,230,200,354.9
2022-09-27T17:00,61.7,100,83,36,41,410,183,227,308.5
2022-09-27T18:00,58.7,100,91,27,43,294,103,191,199.8
2022-09-27T19:00,58.6,98,75,29,45,306,90,216,134.2
2022-09-27T20:00,59.4,54,17,38,54,310,119,191,175.5
2022-09-27T21:00,59.3,59,28,30,53,210,85,125,214.8
2022-09-27T22:00,58.4,65,31,17,89,103,37,66,177.7
2022-09-27T23:00,57.2,69,24,40,78,27,8,19,83
2022-09-28T00:00,56.1,62,13,45,78,0,0,0,0
2022-09-28T01:00,55.3,98,40,67,73,0,0,0,0
2022-09-28T02:00,54.9,100,47,77,71,0,0,0,0
2022-09-28T03:00,54.3,87,22,74,75,0,0,0,0
2022-09-28T04:00,54,100,18,99,98,0,0,0,0
2022-09-28T05:00,54.1,100,40,97,100,0,0,0,0
2022-09-28T06:00,54.1,100,83,97,98,0,0,0,0
2022-09-28T07:00,53,100,71,93,94,0,0,0,0
2022-09-28T08:00,52.7,100,98,93,85,0,0,0,0
2022-09-28T09:00,52.8,100,92,48,44,0,0,0,0
2022-09-28T10:00,52.9,100,100,22,58,0,0,0,0
2022-09-28T11:00,53.4,100,100,28,62,0,0,0,0
2022-09-28T12:00,53.7,100,88,45,49,17,2,15,0
2022-09-28T13:00,54.9,100,93,66,4,89,37,52,84.9
2022-09-28T14:00,56.6,100,95,45,9,106,17,89,96.2
2022-09-28T15:00,56.8,85,75,24,11,122,6,116,20.2
2022-09-28T16:00,57.2,96,88,15,26,211,24,187,18.3
2022-09-28T17:00,57.2,91,87,11,21,282,91,191,76.4
2022-09-28T18:00,58.3,87,76,14,35,400,204,196,213.3
2022-09-28T19:00,59.7,71,58,18,26,391,181,210,293.1
2022-09-28T20:00,58.5,63,46,19,33,265,141,124,263.5
2022-09-28T21:00,57.7,43,36,13,11,251,147,104,311.7
2022-09-28T22:00,56.6,61,59,12,3,117,48,69,285.3
2022-09-28T23:00,55.2,77,84,3,0,27,9,18,100.1
2022-09-29T00:00,54.7,77,85,1,0,0,0,0,0
2022-09-29T01:00,54,86,96,0,0,0,0,0,0
2022-09-29T02:00,53.8,84,93,1,0,0,0,0,0
2022-09-29T03:00,53.4,86,93,4,0,0,0,0,0
2022-09-29T04:00,53.3,92,94,13,0,0,0,0,0
2022-09-29T05:00,52.9,85,86,13,0,0,0,0,0
2022-09-29T06:00,52.2,88,88,15,0,0,0,0,0
2022-09-29T07:00,52,80,88,1,0,0,0,0,0
2022-09-29T08:00,51.8,88,98,0,0,0,0,0,0
2022-09-29T09:00,51.7,90,100,0,0,0,0,0,0
2022-09-29T10:00,51.5,90,100,0,0,0,0,0,0
2022-09-29T11:00,51.6,90,100,0,0,0,0,0,0
2022-09-29T12:00,51.9,88,98,0,0,13,0,13,0
2022-09-29T13:00,52.3,82,91,0,0,62,1,61,0.3
2022-09-29T14:00,53,77,85,0,0,154,23,131,21.7
2022-09-29T15:00,53.9,79,88,0,0,300,122,178,139.4
2022-09-29T16:00,54.8,84,93,0,0,365,101,264,188.2
2022-09-29T17:00,55.6,62,69,0,0,486,204,282,219.1
2022-09-29T18:00,56.4,41,45,0,0,496,212,284,295.5
2022-09-29T19:00,56.7,11,12,0,0,532,327,205,401.1
2022-09-29T20:00,56.8,6,7,0,0,484,336,148,566.4
2022-09-29T21:00,56.3,0,0,0,0,373,295,78,681.9
2022-09-29T22:00,54.9,0,0,0,0,192,139,53,671.9
2022-09-29T23:00,52.7,0,0,0,0,37,21,16,282
2022-09-30T00:00,51.1,0,0,0,0,0,0,0,0
2022-09-30T01:00,49.2,0,0,0,0,0,0,0,0
2022-09-30T02:00,48.3,0,0,0,0,0,0,0,0
2022-09-30T03:00,47.7,0,0,0,0,0,0,0,0
2022-09-30T04:00,47.1,0,0,0,0,0,0,0,0
2022-09-30T05:00,46.1,0,0,0,0,0,0,0,0
2022-09-30T06:00,45.7,0,0,0,0,0,0,0,0
2022-09-30T07:00,44.7,0,0,0,0,0,0,0,0
2022-09-30T08:00,43.9,0,0,0,0,0,0,0,0
2022-09-30T09:00,44.3,0,0,0,0,0,0,0,0
2022-09-30T10:00,42.6,1,0,0,4,0,0,0,0
2022-09-30T11:00,42.6,11,2,0,29,0,0,0,0
2022-09-30T12:00,43.4,36,16,0,72,44,23,21,0
2022-09-30T13:00,48.2,35,5,0,100,188,117,71,374.8
2022-09-30T14:00,51.8,31,1,0,100,351,226,125,497.2
2022-09-30T15:00,55,30,0,0,99,490,325,165,561.2
2022-09-30T16:00,57.7,29,0,0,97,596,407,189,604.8
2022-09-30T17:00,60,30,0,0,100,665,494,171,674
2022-09-30T18:00,61.3,30,0,0,100,645,441,204,684.4
2022-09-30T19:00,61.2,30,0,0,100,554,327,227,574.6
2022-09-30T20:00,61.2,30,0,0,100,455,265,190,503.1
2022-09-30T21:00,60.3,30,0,0,100,295,145,150,435.3
2022-09-30T22:00,58.1,30,0,0,100,138,41,97,272.7
2022-09-30T23:00,56.3,30,0,0,100,21,0,21,64.1
2022-10-01T00:00,54.4,30,0,0,100,0,0,0,0
2022-10-01T01:00,53.4,30,0,0,100,0,0,0,0
2022-10-01T02:00,52.9,30,0,0,100,0,0,0,0
2022-10-01T03:00,52.3,30,0,0,100,0,0,0,0
2022-10-01T04:00,52,30,0,0,100,0,0,0,0
2022-10-01T05:00,51.7,30,0,0,100,0,0,0,0
2022-10-01T06:00,51.4,30,0,0,100,0,0,0,0
2022-10-01T07:00,50.5,34,0,6,100,0,0,0,0
2022-10-01T08:00,50.5,35,0,9,100,0,0,0,0
2022-10-01T09:00,50.4,52,0,37,100,0,0,0,0
2022-10-01T10:00,50.2,65,0,59,100,0,0,0,0
2022-10-01T11:00,50.6,82,0,87,100,0,0,0,0
2022-10-01T12:00,50.9,91,1,100,100,10,0,10,0
2022-10-01T13:00,51.6,88,0,97,100,48,0,48,0
2022-10-01T14:00,52.3,81,0,86,99,87,5,82,1.3
2022-10-01T15:00,54.9,60,0,55,89,215,73,142,72.3
2022-10-01T16:00,55.1,53,0,52,73,232,75,157,125.9
2022-10-01T17:00,57.2,39,0,50,31,377,142,235,155.3
2022-10-01T18:00,58,35,0,54,9,386,217,169,256.2
2022-10-01T19:00,63.2,26,0,41,5,494,319,175,413.5
2022-10-01T20:00,62.9,25,0,30,24,392,270,122,521.4
2022-10-01T21:00,61.5,28,0,30,33,236,124,112,411
2022-10-01T22:00,59.4,36,0,44,32,127,77,50,325.2
2022-10-01T23:00,57.4,34,0,36,40,22,11,11,150.8
2022-10-02T00:00,56,29,0,25,48,0,0,0,0
2022-10-02T01:00,55.4,29,0,23,50,0,0,0,0
2022-10-02T02:00,54.8,31,0,27,48,0,0,0,0
2022-10-02T03:00,54.2,36,0,24,71,0,0,0,0
2022-10-02T04:00,53.8,39,0,20,89,0,0,0,0
2022-10-02T05:00,53.4,37,1,14,93,0,0,0,0
2022-10-02T06:00,53.1,42,1,20,98,0,0,0,0
2022-10-02T07:00,52.6,38,2,12,95,0,0,0,0
2022-10-02T08:00,52,37,3,8,98,0,0,0,0
2022-10-02T09:00,51.5,34,3,2,99,0,0,0,0
2022-10-02T10:00,50.9,33,7,0,89,0,0,0,0
2022-10-02T11:00,50.3,23,1,2,70,0,0,0,0
2022-10-02T12:00,50.1,28,3,0,85,31,7,24,0
2022-10-02T13:00,51.1,34,5,0,98,152,52,100,139.8
2022-10-02T14:00,53.1,34,5,0,99,328,201,127,344.5
2022-10-02T15:00,55.1,48,20,0,100,470,316,154,540.4
2022-10-02T16:00,57.2,42,13,0,100,565,396,169,598.6
2022-10-02T17:00,60.1,36,7,0,100,655,485,170,665.5
2022-10-02T18:00,61.6,61,34,0,100,652,473,179,716.5
2022-10-02T19:00,59.6,65,39,0,100,518,269,249,567.2
2022-10-02T20:00,59.4,65,39,0,100,386,182,204,378.3
2022-10-02T21:00,58.6,57,30,0,100,263,119,144,326.1
2022-10-02T22:00,57,39,10,0,100,128,48,80,264.9
2022-10-02T23:00,54.6,29,0,0,97,22,6,16,88.1
2022-10-03T00:00,52.4,27,0,0,90,0,0,0,0
2022-10-03T01:00,50.8,17,0,0,57,0,0,0,0
2022-10-03T02:00,49.6,11,0,0,35,0,0,0,0
2022-10-03T03:00,48.5,5,0,0,17,0,0,0,0
2022-10-03T04:00,47.7,10,0,0,34,0,0,0,0
2022-10-03T05:00,46.8,11,0,0,35,0,0,0,0
2022-10-03T06:00,46.1,18,0,0,60,0,0,0,0
2022-10-03T07:00,45.2,24,0,0,79,0,0,0,0
2022-10-03T08:00,45,30,0,0,100,0,0,0,0
2022-10-03T09:00,44.7,30,0,0,100,0,0,0,0
2022-10-03T10:00,44.4,30,0,0,100,0,0,0,0
2022-10-03T11:00,44.1,30,0,0,100,0,0,0,0
2022-10-03T12:00,44.5,30,0,0,100,30,5,25,0
2022-10-03T13:00,46.5,30,0,0,100,148,39,109,107.2
2022-10-03T14:00,49.4,30,0,0,100,304,131,173,232.8
2022-10-03T15:00,52.7,30,0,0,100,474,276,198,410
2022-10-03T16:00,55.5,30,0,0,100,619,457,162,617.2
2022-10-03T17:00,57.6,30,0,0,100,692,542,150,770.9
2022-10-03T18:00,58.2,30,0,0,100,660,469,191,769.7
2022-10-03T19:00,56.7,30,0,0,100,434,134,300,455.3
2022-10-03T20:00,56.6,30,0,0,100,352,104,248,190.3
2022-10-03T21:00,55.8,30,0,0,100,238,51,187,168.2
2022-10-03T22:00,54,30,0,0,100,110,17,93,106.9
2022-10-03T23:00,52,30,0,0,100,16,0,16,26.4
2022-10-04T00:00,50.6,30,0,0,100,0,0,0,0
2022-10-04T01:00,49.8,30,0,0,100,0,0,0,0
2022-10-04T02:00,49.5,31,0,2,100,0,0,0,0
2022-10-04T03:00,49.3,50,0,34,100,0,0,0,0
2022-10-04T04:00,49,71,0,69,100,0,0,0,0
2022-10-04T05:00,48.9,85,0,93,98,0,0,0,0
2022-10-04T06:00,48.7,68,0,64,97,0,0,0,0
2022-10-04T07:00,47.7,79,0,87,90,0,0,0,0
2022-10-04T08:00,47.7,61,0,60,84,0,0,0,0
2022-10-04T09:00,47.6,65,0,61,94,0,0,0,0
2022-10-04T10:00,47.1,63,0,59,91,0,0,0,0
2022-10-04T11:00,46.8,71,0,77,83,0,0,0,0
2022-10-04T12:00,47.2,56,0,53,82,14,3,11,0
2022-10-04T13:00,48.6,58,0,54,86,111,35,76,89.4
2022-10-04T14:00,49.8,77,0,80,98,207,94,113,194.4
2022-10-04T15:00,50.9,53,0,39,97,236,77,159,194.9
2022-10-04T16:00,51.1,70,3,64,96,197,38,159,90.7
2022-10-04T17:00,52.5,89,1,99,97,389,170,219,154.3
2022-10-04T18:00,53.1,78,0,90,79,293,116,177,209.6
2022-10-04T19:00,56.5,41,0,22,94,427,276,151,317.7
2022-10-04T20:00,56.2,35,0,8,100,214,72,142,311.1
2022-10-04T21:00,55.4,29,0,0,98,144,20,124,81.8
2022-10-04T22:00,53.7,72,0,70,99,76,22,54,76.5
2022-10-04T23:00,52,63,0,57,96,16,3,13,40.3
2022-10-05T00:00,51.1,59,0,49,97,0,0,0,0
2022-10-05T01:00,50.3,54,0,41,97,0,0,0,0
2022-10-05T02:00,50.1,50,0,35,97,0,0,0,0
2022-10-05T03:00,49.9,50,0,36,95,0,0,0,0
2022-10-05T04:00,49.7,41,3,51,26,0,0,0,0
2022-10-05T05:00,49.5,32,4,32,32,0,0,0,0
2022-10-05T06:00,49.5,42,7,39,42,0,0,0,0
2022-10-05T07:00,49.9,30,2,21,52,0,0,0,0
2022-10-05T08:00,49.5,21,0,4,62,0,0,0,0
2022-10-05T09:00,48.9,23,0,0,77,0,0,0,0
2022-10-05T10:00,48.9,20,0,0,68,0,0,0,0
2022-10-05T11:00,48.7,18,0,0,61,0,0,0,0
2022-10-05T12:00,48.9,16,0,0,54,35,19,16,0
2022-10-05T13:00,52.3,14,0,0,48,194,138,56,423
2022-10-05T14:00,55.8,11,0,0,35,365,297,68,664.8
2022-10-05T15:00,59.4,7,0,0,24,519,432,87,776.5
2022-10-05T16:00,62.6,5,0,0,15,636,549,87,843.6
2022-10-05T17:00,64.8,3,0,0,9,702,619,83,903.3
2022-10-05T18:00,66.1,1,0,0,4,695,611,84,924.3
2022-10-05T19:00,66.6,0,0,0,0,621,539,82,902.2
2022-10-05T20:00,66.2,0,0,0,0,503,427,76,861.8
2022-10-05T21:00,64.8,0,0,0,0,339,273,66,790.3
2022-10-05T22:00,61.7,0,0,0,0,160,114,46,657.1
2022-10-05T23:00,59,0,0,0,0,20,10,10,184.5
2022-10-06T00:00,57.3,0,0,0,0,0,0,0,0
2022-10-06T01:00,55.9,0,0,0,0,0,0,0,0
2022-10-06T02:00,54.8,1,0,0,4,0,0,0,0
2022-10-06T03:00,55.7,8,0,0,25,0,0,0,0
2022-10-06T04:00,56.3,13,0,0,42,0,0,0,0
2022-10-06T05:00,56,19,0,0,63,0,0,0,0
2022-10-06T06:00,55.3,23,0,0,77,0,0,0,0
2022-10-06T07:00,55,21,0,0,71,0,0,0,0
2022-10-06T08:00,55.6,24,0,0,79,0,0,0,0
2022-10-06T09:00,55.3,21,0,0,71,0,0,0,0
2022-10-06T10:00,54.9,14,0,0,46,0,0,0,0
2022-10-06T11:00,54.3,16,0,0,53,0,0,0,0
2022-10-06T12:00,50.4,17,0,1,56,31,16,15,0
2022-10-06T13:00,56.7,16,0,4,44,178,123,55,376.5
2022-10-06T14:00,63.3,14,0,0,45,348,273,75,609.6
2022-10-06T15:00,67.2,26,0,11,64,498,412,86,734.8
2022-10-06T16:00,69.7,23,0,15,46,607,520,87,810.1
2022-10-06T17:00,71.6,15,0,8,35,661,569,92,850
2022-10-06T18:00,72.9,19,0,5,54,649,541,108,841.5
2022-10-06T19:00,73.8,35,0,13,89,569,449,120,794.3
2022-10-06T20:00,73.3,49,0,33,97,344,194,150,569.7
2022-10-06T21:00,71.4,60,0,51,98,202,75,127,284
2022-10-06T22:00,69.5,47,0,30,98,83,24,59,159.8
2022-10-06T23:00,67.7,51,0,36,97,11,1,10,35.3
2022-10-07T00:00,63.9,58,0,46,100,0,0,0,0
2022-10-07T01:00,62,57,0,45,100,0,0,0,0
2022-10-07T02:00,61.2,61,0,52,100,0,0,0,0
2022-10-07T03:00,60.9,79,0,82,100,0,0,0,0
2022-10-07T04:00,59.8,85,0,95,93,0,0,0,0
2022-10-07T05:00,58.7,71,0,91,55,0,0,0,0
2022-10-07T06:00,58,33,0,20,71,0,0,0,0
2022-10-07T07:00,58.1,27,0,1,88,0,0,0,0
2022-10-07T08:00,57.3,17,0,9,39,0,0,0,0
2022-10-07T09:00,56.1,19,0,31,0,0,0,0,0
2022-10-07T10:00,55.8,18,1,29,0,0,0,0,0
2022-10-07T11:00,55.8,50,32,35,0,0,0,0,0
2022-10-07T12:00,55.7,100,92,56,0,16,6,10,0
2022-10-07T13:00,57.7,100,99,57,0,52,17,35,87.7
2022-10-07T14:00,57.9,100,100,39,0,67,2,65,39
2022-10-07T15:00,57.4,100,100,19,0,70,0,70,0.5
2022-10-07T16:00,56.2,94,100,7,0,116,0,116,0
2022-10-07T17:00,55.9,100,100,11,29,219,48,171,26.7
2022-10-07T18:00,56.3,100,100,12,67,370,189,181,193.2
2022-10-07T19:00,56.3,100,100,4,33,154,8,146,162.6
2022-10-07T20:00,55,91,100,2,0,106,1,105,1.1
2022-10-07T21:00,53.8,91,100,2,0,68,0,68,0.3
2022-10-07T22:00,52.4,88,93,7,0,47,8,39,21.1
2022-10-07T23:00,51.3,97,86,33,0,6,1,5,12.9
2022-10-08T00:00,50.2,100,86,50,0,0,0,0,0
2022-10-08T01:00,49.6,100,90,66,0,0,0,0,0
2022-10-08T02:00,48.9,97,72,54,0,0,0,0,0
2022-10-08T03:00,48.6,82,58,50,0,0,0,0,0
2022-10-08T04:00,48,75,37,69,0,0,0,0,0
2022-10-08T05:00,47.6,100,65,85,0,0,0,0,0
2022-10-08T06:00,47,71,55,35,0,0,0,0,0
2022-10-08T07:00,45.9,66,71,4,0,0,0,0,0
2022-10-08T08:00,45.4,71,78,1,0,0,0,0,0
2022-10-08T09:00,45,70,78,0,0,0,0,0,0
2022-10-08T10:00,44.9,66,73,0,0,0,0,0,0
2022-10-08T11:00,44.7,68,76,0,0,0,0,0,0
2022-10-08T12:00,44.7,84,89,6,0,14,4,10,0
2022-10-08T13:00,45.8,100,98,20,0,112,60,52,163
2022-10-08T14:00,46.9,74,78,7,0,200,103,97,268.1
2022-10-08T15:00,48.7,79,84,5,0,350,184,166,313.8
2022-10-08T16:00,49.6,90,99,2,0,331,128,203,286.2
2022-10-08T17:00,50.6,91,100,1,0,401,134,267,198.1
2022-10-08T18:00,51.7,89,99,0,0,429,175,254,243
2022-10-08T19:00,51.4,90,100,0,0,307,63,244,192.6
2022-10-08T20:00,51.5,90,100,0,0,240,40,200,83
2022-10-08T21:00,51.6,79,88,0,0,200,62,138,126.2
2022-10-08T22:00,51.1,59,65,0,3,94,30,64,173.2
2022-10-08T23:00,50.1,32,35,0,1,11,4,7,44.5
2022-10-09T00:00,49.1,30,33,1,0,0,0,0,0
2022-10-09T01:00,47.7,50,51,7,0,0,0,0,0
2022-10-09T02:00,47.1,65,66,9,0,0,0,0,0
2022-10-09T03:00,47,87,85,18,0,0,0,0,0
2022-10-09T04:00,47,86,83,18,0,0,0,0,0
2022-10-09T05:00,47.2,79,82,9,0,0,0,0,0
2022-10-09T06:00,46.8,62,62,11,0,0,0,0,0
2022-10-09T07:00,46.6,33,35,3,0,0,0,0,0
2022-10-09T08:00,46,27,29,2,0,0,0,0,0
2022-10-09T09:00,46,36,34,0,17,0,0,0,0
2022-10-09T10:00,45.4,20,16,0,20,0,0,0,0
2022-10-09T11:00,45,10,2,0,28,0,0,0,0
2022-10-09T12:00,45.4,10,1,0,31,26,11,15,0
2022-10-09T13:00,47.9,3,1,2,3,169,116,53,342.7
2022-10-09T14:00,51.2,6,1,8,0,345,266,79,612.6
2022-10-09T15:00,54.2,34,32,8,0,488,392,96,733.4
2022-10-09T16:00,57,100,100,51,0,552,413,139,734.3
2022-10-09T17:00,58.5,100,97,97,0,458,263,195,556.8
2022-10-09T18:00,58.5,99,50,90,0,248,19,229,204.8
2022-10-09T19:00,59,80,31,86,0,258,69,189,52
2022-10-09T20:00,59.1,60,13,81,0,239,115,124,177.3
2022-10-09T21:00,58.4,56,18,66,0,193,93,100,258
2022-10-09T22:00,56.6,42,4,64,0,76,34,42,231.9
2022-10-09T23:00,55.2,35,10,44,0,10,3,7,44.7
2022-10-10T00:00,53.9,39,12,47,0,0,0,0,0
2022-10-10T01:00,53.1,43,19,43,0,0,0,0,0
2022-10-10T02:00,52.3,48,21,49,0,0,0,0,0
2022-10-10T03:00,51.3,47,24,42,0,0,0,0,0
2022-10-10T04:00,50.4,50,23,48,0,0,0,0,0
2022-10-10T05:00,49.6,50,11,65,4,0,0,0,0
2022-10-10T06:00,49.5,87,12,90,74,0,0,0,0
2022-10-10T07:00,49.9,100,15,98,91,0,0,0,0
2022-10-10T08:00,49.5,90,7,97,85,0,0,0,0
2022-10-10T09:00,49.4,92,7,94,97,0,0,0,0
2022-10-10T10:00,49.2,85,9,90,77,0,0,0,0
2022-10-10T11:00,48.5,56,7,72,22,0,0,0,0
2022-10-10T12:00,48.4,34,8,33,24,13,4,9,0
2022-10-10T13:00,49.4,37,18,27,16,97,40,57,118.2
2022-10-10T14:00,52.1,48,18,49,9,238,137,101,274.2
2022-10-10T15:00,54.1,55,29,48,0,301,172,129,351.5
2022-10-10T16:00,56.3,44,27,32,0,395,248,147,377.2
2022-10-10T17:00,57.2,50,32,35,0,360,186,174,351
2022-10-10T18:00,58.2,57,39,37,0,380,230,150,318.6
2022-10-10T19:00,58.7,60,45,33,0,354,202,152,347.3
2022-10-10T20:00,59.1,46,37,21,0,369,262,107,442.5
2022-10-10T21:00,58.3,25,24,5,0,256,176,80,538.1
2022-10-10T22:00,56.1,19,21,0,0,119,73,46,473.2
2022-10-10T23:00,53.4,11,12,0,0,10,4,6,88
2022-10-11T00:00,51.8,2,2,0,0,0,0,0,0
2022-10-11T01:00,50.4,4,4,0,0,0,0,0,0
2022-10-11T02:00,48.6,2,2,0,0,0,0,0,0
2022-10-11T03:00,47.5,0,0,0,0,0,0,0,0
2022-10-11T04:00,46.9,0,0,0,0,0,0,0,0
2022-10-11T05:00,46.4,0,0,0,0,0,0,0,0
2022-10-11T06:00,45.9,0,0,0,0,0,0,0,0
2022-10-11T07:00,45.2,0,0,0,0,0,0,0,0
2022-10-11T08:00,44.8,0,0,0,0,0,0,0,0
2022-10-11T09:00,44.2,24,13,21,0,0,0,0,0
2022-10-11T10:00,44.4,36,14,39,0,0,0,0,0
2022-10-11T11:00,44.8,37,8,50,0,0,0,0,0
2022-10-11T12:00,46,50,5,75,0,19,9,10,0
2022-10-11T13:00,50.4,45,2,72,0,119,53,66,201
2022-10-11T14:00,55.5,32,2,51,0,241,119,122,275.6
2022-10-11T15:00,59.8,18,1,29,0,401,251,150,397
2022-10-11T16:00,63.8,10,0,17,0,537,423,114,603.1
2022-10-11T17:00,67,4,0,6,0,607,506,101,756.8
2022-10-11T18:00,69.3,1,0,1,0,606,501,105,790.3
2022-10-11T19:00,70.8,0,0,0,0,575,492,83,821.1
2022-10-11T20:00,71,8,0,14,0,458,380,78,828.5
2022-10-11T21:00,69.3,1,0,2,0,302,236,66,751
2022-10-11T22:00,65.9,11,0,19,0,128,86,42,610.6
2022-10-11T23:00,62,11,0,18,0,9,4,5,93.7
2022-10-12T00:00,59.4,7,0,12,0,0,0,0,0
2022-10-12T01:00,57.9,3,0,5,0,0,0,0,0
2022-10-12T02:00,56.7,0,0,0,0,0,0,0,0
2022-10-12T03:00,55.6,0,0,0,0,0,0,0,0
2022-10-12T04:00,54.6,1,0,0,4,0,0,0,0
2022-10-12T05:00,53.9,29,0,0,98,0,0,0,0
2022-10-12T06:00,53.5,28,0,0,93,0,0,0,0
2022-10-12T07:00,53.1,0,0,0,0,0,0,0,0
2022-10-12T08:00,52.7,4,0,0,13,0,0,0,0
2022-10-12T09:00,52.3,26,0,0,86,0,0,0,0
2022-10-12T10:00,52.1,26,0,0,87,0,0,0,0
2022-10-12T11:00,51.9,25,0,0,84,0,0,0,0
2022-10-12T12:00,52.2,24,0,5,71,20,8,12,0
2022-10-12T13:00,55.4,28,0,0,92,155,92,63,282.9
2022-10-12T14:00,59.5,30,0,0,100,323,228,95,529.7
2022-10-12T15:00,63,29,0,1,96,458,332,126,640.9
2022-10-12T16:00,65.8,34,0,7,99,552,399,153,670.5
2022-10-12T17:00,67.8,32,0,3,99,573,387,186,641.8
2022-10-12T18:00,69.1,30,0,0,99,573,382,191,613
2022-10-12T19:00,68.9,30,0,0,100,459,236,223,513.2
2022-10-12T20:00,68.5,31,0,1,100,345,164,181,378.8
2022-10-12T21:00,67.2,61,0,52,100,196,55,141,260.8
2022-10-12T22:00,65.1,85,0,92,99,47,1,46,79.5
2022-10-12T23:00,63.7,64,0,56,100,5,0,5,0
2022-10-13T00:00,63,76,0,79,95,0,0,0,0
2022-10-13T01:00,61.4,67,0,88,48,0,0,0,0
2022-10-13T02:00,60.6,30,0,44,11,0,0,0,0
2022-10-13T03:00,59.8,41,0,56,24,0,0,0,0
2022-10-13T04:00,59.4,41,0,26,85,0,0,0,0
2022-10-13T05:00,59,59,0,49,98,0,0,0,0
2022-10-13T06:00,58.7,82,0,86,100,0,0,0,0
2022-10-13T07:00,58.5,86,0,93,100,0,0,0,0
2022-10-13T08:00,59.1,64,0,57,100,0,0,0,0
2022-10-13T09:00,59.4,44,4,18,100,0,0,0,0
2022-10-13T10:00,59.4,44,0,23,99,0,0,0,0
2022-10-13T11:00,59.6,69,0,71,87,0,0,0,0
2022-10-13T12:00,57.6,72,8,71,73,7,0,7,0
2022-10-13T13:00,58.8,81,21,57,94,15,0,15,0
2022-10-13T14:00,59.4,100,53,95,82,67,18,49,18.6
2022-10-13T15:00,60.9,100,49,91,77,191,89,102,114.2
2022-10-13T16:00,62.8,100,54,83,9,263,109,154,192.1
2022-10-13T17:00,63.4,100,93,94,35,189,40,149,127.1
2022-10-13T18:00,64,100,100,100,61,155,17,138,41.4
2022-10-13T19:00,61.2,100,78,94,61,87,3,84,15.1
2022-10-13T20:00,60,100,31,97,52,51,0,51,0.8
2022-10-13T21:00,59.2,66,2,95,23,71,31,40,47.5
2022-10-13T22:00,57.6,62,0,96,13,36,10,26,84.7
2022-10-13T23:00,57,53,1,84,7,2,0,2,8.7
2022-10-14T00:00,56.7,59,0,92,11,0,0,0,0
2022-10-14T01:00,57,62,7,88,11,0,0,0,0
2022-10-14T02:00,54.4,86,29,99,3,0,0,0,0
2022-10-14T03:00,53.4,60,0,100,0,0,0,0,0
2022-10-14T04:00,52.3,62,0,100,5,0,0,0,0
2022-10-14T05:00,50.7,65,0,96,23,0,0,0,0
2022-10-14T06:00,49.4,47,0,59,39,0,0,0,0
2022-10-14T07:00,48.9,21,0,34,1,0,0,0,0
2022-10-14T08:00,50.1,1,0,1,0,0,0,0,0
2022-10-14T09:00,48.6,0,0,0,0,0,0,0,0
2022-10-14T10:00,47.4,0,0,0,0,0,0,0,0
2022-10-14T11:00,44.1,0,0,0,0,0,0,0,0
2022-10-14T12:00,44.4,2,0,3,0,20,10,10,0
2022-10-14T13:00,49.8,0,0,0,0,159,113,46,367.8
2022-10-14T14:00,53.9,0,0,0,0,334,267,67,651.1
2022-10-14T15:00,57.5,22,2,33,0,483,402,81,777.1
2022-10-14T16:00,60,24,2,37,0,579,489,90,831.3
2022-10-14T17:00,61.3,31,2,49,0,580,480,100,821.9
2022-10-14T18:00,61.5,42,3,66,0,411,205,206,552.3
2022-10-14T19:00,61.8,30,0,50,0,359,148,211,277.6
2022-10-14T20:00,61.8,24,0,40,0,300,138,162,268.6
2022-10-14T21:00,61.2,19,0,31,0,249,164,85,405.4
2022-10-14T22:00,58.9,16,0,27,0,108,67,41,486.3
2022-10-14T23:00,56.1,9,0,15,0,6,2,4,54.3
2022-10-15T00:00,54.3,7,0,11,0,0,0,0,0
2022-10-15T01:00,53.1,1,0,2,0,0,0,0,0
2022-10-15T02:00,52.3,4,0,7,0,0,0,0,0
2022-10-15T03:00,51.6,24,0,40,0,0,0,0,0
2022-10-15T04:00,51.8,54,0,90,0,0,0,0,0
2022-10-15T05:00,52.2,46,0,76,0,0,0,0,0
2022-10-15T06:00,51.8,4,0,7,0,0,0,0,0
2022-10-15T07:00,49.5,12,0,20,0,0,0,0,0
2022-10-15T08:00,49.6,6,0,6,7,0,0,0,0
2022-10-15T09:00,49.6,28,0,2,89,0,0,0,0
2022-10-15T10:00,49.6,54,0,43,93,0,0,0,0
2022-10-15T11:00,49.7,44,0,26,93,0,0,0,0
2022-10-15T12:00,50.3,9,0,1,29,15,4,11,0
2022-10-15T13:00,53.1,2,0,4,0,143,97,46,274.8
2022-10-15T14:00,57.3,2,0,3,0,306,230,76,568.3
2022-10-15T15:00,61.2,10,0,16,0,472,396,76,730.4
2022-10-15T16:00,64.4,9,0,15,0,536,422,114,785.4
2022-10-15T17:00,66.5,9,1,13,0,518,310,208,611.5
2022-10-15T18:00,67.2,46,1,42,65,463,322,141,503.6
2022-10-15T19:00,67.8,61,2,52,93,398,268,130,510.2
2022-10-15T20:00,67,45,9,33,58,275,145,130,391.2
2022-10-15T21:00,64.8,21,8,23,0,227,153,74,393.4
2022-10-15T22:00,61,15,3,20,0,99,62,37,460.3
2022-10-15T23:00,57.4,7,0,12,0,4,1,3,44.4
2022-10-16T00:00,54.6,7,1,10,0,0,0,0,0
2022-10-16T01:00,52.1,4,2,3,0,0,0,0,0
2022-10-16T02:00,50.4,3,2,2,0,0,0,0,0
2022-10-16T03:00,49.1,0,0,0,0,0,0,0,0
2022-10-16T04:00,47.7,0,0,0,0,0,0,0,0
2022-10-16T05:00,46.7,0,0,0,0,0,0,0,0
2022-10-16T06:00,46.2,0,0,0,0,0,0,0,0
2022-10-16T07:00,45.4,5,0,0,16,0,0,0,0
2022-10-16T08:00,45,5,0,0,18,0,0,0,0
2022-10-16T09:00,44.6,5,0,0,18,0,0,0,0
2022-10-16T10:00,44.2,19,0,7,49,0,0,0,0
2022-10-16T11:00,44,34,0,26,60,0,0,0,0
2022-10-16T12:00,44.7,10,0,0,33,14,5,9,0
2022-10-16T13:00,48,10,0,0,32,137,75,62,232.7
2022-10-16T14:00,52.1,16,0,0,52,306,229,77,514.4
2022-10-16T15:00,55.2,3,0,0,9,467,383,84,722.3
2022-10-16T16:00,57.5,1,0,0,3,572,484,88,820.1
2022-10-16T17:00,59.4,2,0,2,1,624,536,88,858.5
2022-10-16T18:00,60.8,6,0,10,0,616,526,90,870.3
2022-10-16T19:00,62.4,7,0,12,0,538,443,95,838.4
2022-10-16T20:00,62.7,24,3,12,47,396,298,98,731.7
2022-10-16T21:00,62.1,63,8,60,67,255,184,71,631
2022-10-16T22:00,60.2,50,2,52,57,86,40,46,432
2022-10-16T23:00,57.3,41,2,49,32,3,1,2,24.1
2022-10-17T00:00,55.2,38,7,50,5,0,0,0,0
2022-10-17T01:00,53.8,23,2,36,0,0,0,0,0
2022-10-17T02:00,52.5,4,1,5,0,0,0,0,0
2022-10-17T03:00,51.3,29,0,5,85,0,0,0,0
2022-10-17T04:00,50.6,40,0,19,96,0,0,0,0
2022-10-17T05:00,50.2,31,0,23,58,0,0,0,0
2022-10-17T06:00,50.1,5,0,7,3,0,0,0,0
2022-10-17T07:00,49.8,14,0,21,4,0,0,0,0
2022-10-17T08:00,49.5,33,0,25,59,0,0,0,0
2022-10-17T09:00,49.3,57,0,45,100,0,0,0,0
2022-10-17T10:00,48.9,71,0,70,97,0,0,0,0
2022-10-17T11:00,48.5,85,0,98,87,0,0,0,0
2022-10-17T12:00,48.6,72,0,96,49,7,0,7,0
2022-10-17T13:00,50.2,65,0,79,57,66,9,57,19
2022-10-17T14:00,53,49,0,76,11,148,49,99,90.8
2022-10-17T15:00,55.1,61,4,94,4,238,103,135,179.8
2022-10-17T16:00,56.1,72,13,75,52,250,121,129,212.9
2022-10-17T17:00,56.8,64,15,49,71,292,181,111,257
2022-10-17T18:00,57.3,41,14,33,27,256,128,128,246.6
2022-10-17T19:00,57.7,37,22,27,2,398,268,130,341.7
2022-10-17T20:00,57.6,37,9,40,16,338,252,86,542.3
2022-10-17T21:00,56.1,59,9,37,95,219,138,81,522.9
2022-10-17T22:00,53.9,59,2,50,91,69,20,49,292.5
2022-10-17T23:00,51.8,48,2,34,87,2,0,2,10
2022-10-18T00:00,50.4,22,6,9,36,0,0,0,0
2022-10-18T01:00,49.1,38,8,20,61,0,0,0,0
2022-10-18T02:00,47.6,16,1,15,20,0,0,0,0
2022-10-18T03:00,46.1,4,0,4,4,0,0,0,0
2022-10-18T04:00,45.3,2,0,2,4,0,0,0,0
2022-10-18T05:00,44.4,11,0,11,13,0,0,0,0
2022-10-18T06:00,43.5,5,0,5,7,0,0,0,0
2022-10-18T07:00,42.4,1,0,1,0,0,0,0,0
2022-10-18T08:00,41.5,7,0,11,0,0,0,0,0
2022-10-18T09:00,41,8,2,11,0,0,0,0,0
2022-10-18T10:00,40.5,38,27,23,0,0,0,0,0
2022-10-18T11:00,40.2,48,37,24,1,0,0,0,0
2022-10-18T12:00,40.5,48,47,9,2,13,5,8,0
2022-10-18T13:00,42.3,71,68,17,0,99,46,53,173.7
2022-10-18T14:00,44.8,69,69,12,0,239,154,85,347.2
2022-10-18T15:00,47.7,94,98,10,0,354,199,155,451.2
2022-10-18T16:00,49.3,60,52,22,0,272,58,214,252.2
2022-10-18T17:00,49.8,47,40,18,0,361,199,162,196.4
2022-10-18T18:00,50.7,62,47,32,0,409,254,155,385.4
2022-10-18T19:00,51.2,85,58,54,0,362,222,140,426
2022-10-18T20:00,50.4,36,10,45,0,267,125,142,340.3
2022-10-18T21:00,48.9,21,14,14,0,202,129,73,350.7
2022-10-18T22:00,47.6,38,1,61,0,86,49,37,393.1
2022-10-18T23:00,45.9,11,0,18,0,3,1,2,23
2022-10-19T00:00,44.5,10,1,15,0,0,0,0,0
2022-10-19T01:00,43.3,1,0,1,0,0,0,0,0
2022-10-19T02:00,42.4,1,0,1,0,0,0,0,0
2022-10-19T03:00,41.6,0,0,0,0,0,0,0,0
2022-10-19T04:00,40.9,0,0,0,0,0,0,0,0
2022-10-19T05:00,40.3,0,0,0,0,0,0,0,0
2022-10-19T06:00,39.6,0,0,0,0,0,0,0,0
2022-10-19T07:00,38.6,0,0,0,0,0,0,0,0
2022-10-19T08:00,38.1,0,0,0,0,0,0,0,0
2022-10-19T09:00,37.8,13,14,0,0,0,0,0,0
2022-10-19T10:00,37.7,55,61,0,0,0,0,0,0
2022-10-19T11:00,38.4,74,69,19,3,0,0,0,0
2022-10-19T12:00,39.4,80,61,39,6,9,2,7,0
2022-10-19T13:00,40.5,61,53,22,0,95,36,59,119.2
2022-10-19T14:00,42.5,100,61,77,0,197,88,109,233.5
2022-10-19T15:00,44,100,78,99,0,235,86,149,224.8
2022-10-19T16:00,44.2,100,88,95,1,230,65,165,150.7
2022-10-19T17:00,45.2,100,80,51,16,178,11,167,58.3
2022-10-19T18:00,47.7,100,41,84,73,312,111,201,87
2022-10-19T19:00,48.9,85,34,56,68,382,228,154,318.6
2022-10-19T20:00,49.1,88,38,60,58,261,101,160,336.2
2022-10-19T21:00,47.3,90,16,86,79,194,91,103,268.9
2022-10-19T22:00,45.7,80,8,86,69,55,12,43,200.6
2022-10-19T23:00,44.5,81,16,87,48,2,0,2,4.1
2022-10-20T00:00,43.5,57,9,62,40,0,0,0,0
2022-10-20T01:00,43.1,90,15,84,87,0,0,0,0
2022-10-20T02:00,42.5,74,37,67,1,0,0,0,0
2022-10-20T03:00,42,94,43,50,84,0,0,0,0
2022-10-20T04:00,41.7,90,54,35,67,0,0,0,0
2022-10-20T05:00,41.3,100,58,62,71,0,0,0,0
2022-10-20T06:00,41.4,100,34,71,96,0,0,0,0
2022-10-20T07:00,41.6,81,19,60,93,0,0,0,0
2022-10-20T08:00,41.4,59,12,43,73,0,0,0,0
2022-10-20T09:00,41.3,46,16,14,77,0,0,0,0
2022-10-20T10:00,40.7,100,82,13,88,0,0,0,0
2022-10-20T11:00,40.3,100,60,73,95,0,0,0,0
2022-10-20T12:00,40.2,100,58,85,93,9,0,9,0
2022-10-20T13:00,41.5,100,73,89,95,77,13,64,33.1
2022-10-20T14:00,43.3,100,52,98,84,175,42,133,92.3
2022-10-20T15:00,45.6,100,41,98,98,340,147,193,222.4
2022-10-20T16:00,47,90,0,100,100,387,135,252,290.2
2022-10-20T17:00,48.1,90,0,100,99,383,102,281,210.2
2022-10-20T18:00,48.6,89,0,99,98,255,23,232,104.8
2022-10-20T19:00,48.4,89,0,99,99,183,0,183,14.3
2022-10-20T20:00,48.8,90,1,100,97,146,0,146,0
2022-10-20T21:00,48.8,90,2,99,96,99,0,99,0
2022-10-20T22:00,47.7,89,0,100,98,36,0,36,0
2022-10-20T23:00,46.7,89,0,100,95,1,0,1,0
2022-10-21T00:00,46.2,90,0,100,100,0,0,0,0
2022-10-21T01:00,45.9,90,2,100,93,0,0,0,0
2022-10-21T02:00,45.5,45,1,73,0,0,0,0,0
2022-10-21T03:00,45.3,25,3,37,0,0,0,0,0
2022-10-21T04:00,44.7,25,15,19,0,0,0,0,0
2022-10-21T05:00,44.2,15,14,4,0,0,0,0,0
2022-10-21T06:00,43.3,9,9,1,0,0,0,0,0
2022-10-21T07:00,41.9,5,0,0,15,0,0,0,0
2022-10-21T08:00,41,0,0,0,1,0,0,0,0
2022-10-21T09:00,40.2,0,0,0,0,0,0,0,0
2022-10-21T10:00,39.7,0,0,0,0,0,0,0,0
2022-10-21T11:00,39.4,0,0,0,1,0,0,0,0
2022-10-21T12:00,39.5,14,0,0,48,11,5,6,0
2022-10-21T13:00,42.9,5,0,0,18,136,95,41,329
2022-10-21T14:00,48,0,0,0,0,307,244,63,643.7
2022-10-21T15:00,52.1,1,0,1,0,454,380,74,779
2022-10-21T16:00,55.4,0,0,0,0,557,476,81,845.3
2022-10-21T17:00,57.9,0,0,0,0,607,524,83,877.1
2022-10-21T18:00,59.5,14,0,0,48,596,514,82,885.2
2022-10-21T19:00,60.8,2,0,0,5,529,451,78,870.4
2022-10-21T20:00,60.6,0,0,0,0,411,341,70,831.6
2022-10-21T21:00,59,4,0,0,14,255,198,57,753.6
2022-10-21T22:00,55.5,1,0,0,3,86,53,33,534.3
2022-10-21T23:00,53,0,0,0,0,1,0,1,13
2022-10-22T00:00,51.7,0,0,0,0,0,0,0,0
2022-10-22T01:00,50.6,0,0,0,0,0,0,0,0
2022-10-22T02:00,50,0,0,0,0,0,0,0,0
2022-10-22T03:00,49.5,0,0,0,0,0,0,0,0
2022-10-22T04:00,49.1,0,0,0,0,0,0,0,0
2022-10-22T05:00,48.6,0,0,0,0,0,0,0,0
2022-10-22T06:00,48.3,0,0,0,0,0,0,0,0
2022-10-22T07:00,48.2,0,0,0,0,0,0,0,0
2022-10-22T08:00,47.8,0,0,0,0,0,0,0,0
2022-10-22T09:00,47.4,0,0,0,0,0,0,0,0
2022-10-22T10:00,47,0,0,0,0,0,0,0,0
2022-10-22T11:00,46.8,0,0,0,0,0,0,0,0
2022-10-22T12:00,46.8,0,0,0,0,10,4,6,0
2022-10-22T13:00,49.6,0,0,0,0,130,90,40,309.4
2022-10-22T14:00,54.3,0,0,0,0,298,237,61,629.6
2022-10-22T15:00,58.7,0,0,0,0,445,372,73,768.3
2022-10-22T16:00,62.5,0,0,0,0,549,470,79,838.8
2022-10-22T17:00,65.3,0,0,0,0,599,517,82,873.3
2022-10-22T18:00,66.9,0,0,0,0,589,508,81,881.5
2022-10-22T19:00,68.4,0,0,0,0,523,446,77,868.7
2022-10-22T20:00,67.9,0,0,0,0,405,335,70,829.2
2022-10-22T21:00,65.4,0,0,0,0,249,192,57,745
2022-10-22T22:00,61,0,0,0,0,83,54,29,515.5
2022-10-22T23:00,58.2,0,0,0,0,1,0,1,10.5
2022-10-23T00:00,56.1,0,0,0,0,0,0,0,0
2022-10-23T01:00,54.3,0,0,0,0,0,0,0,0
2022-10-23T02:00,53.1,0,0,0,0,0,0,0,0
2022-10-23T03:00,52.2,0,0,0,1,0,0,0,0
2022-10-23T04:00,51.2,0,0,0,0,0,0,0,0
2022-10-23T05:00,50.2,0,0,0,0,0,0,0,0
2022-10-23T06:00,49.4,2,0,0,5,0,0,0,0
2022-10-23T07:00,48.4,3,0,0,10,0,0,0,0
2022-10-23T08:00,47.6,2,0,0,5,0,0,0,0
2022-10-23T09:00,46.8,1,0,0,2,0,0,0,0
2022-10-23T10:00,46.8,0,0,0,0,0,0,0,0
2022-10-23T11:00,46.3,0,0,0,1,0,0,0,0
2022-10-23T12:00,46,0,0,0,0,9,4,5,0
2022-10-23T13:00,49.5,3,0,0,10,128,88,40,313.9
2022-10-23T14:00,55.7,18,0,0,61,294,228,66,623.3
2022-10-23T15:00,60.1,28,0,0,92,428,331,97,719.1
2022-10-23T16:00,63.1,29,0,0,96,525,404,121,738.8
2022-10-23T17:00,65.3,26,0,0,86,569,435,134,751.2
2022-10-23T18:00,66.3,17,0,0,58,539,384,155,708.6
2022-10-23T19:00,66.7,23,0,0,77,488,354,134,673.8
2022-10-23T20:00,66.5,22,0,0,74,385,282,103,687.2
2022-10-23T21:00,64.3,17,0,0,58,230,151,79,621.4
2022-10-23T22:00,61.1,20,1,0,65,72,34,38,378.8
2022-10-23T23:00,58.6,25,0,0,83,1,0,1,4.7
2022-10-24T00:00,57.3,28,0,0,93,0,0,0,0
2022-10-24T01:00,56.2,31,0,2,100,0,0,0,0
2022-10-24T02:00,55.6,37,0,17,89,0,0,0,0
2022-10-24T03:00,55.2,44,0,31,84,0,0,0,0
2022-10-24T04:00,54.4,54,0,42,96,0,0,0,0
2022-10-24T05:00,54,58,0,50,93,0,0,0,0
2022-10-24T06:00,53.6,73,1,75,90,0,0,0,0
2022-10-24T07:00,53.8,78,0,80,100,0,0,0,0
2022-10-24T08:00,53.2,82,0,89,95,0,0,0,0
2022-10-24T09:00,52.9,67,0,67,89,0,0,0,0
2022-10-24T10:00,52.3,33,1,34,39,0,0,0,0
2022-10-24T11:00,52.2,26,3,35,6,0,0,0,0
2022-10-24T12:00,51.9,30,4,42,4,6,2,4,0
2022-10-24T13:00,53.1,33,2,47,11,72,39,33,145.8
2022-10-24T14:00,55.9,25,5,33,1,182,115,67,300.4
2022-10-24T15:00,57.9,28,8,34,2,293,185,108,388.8
2022-10-24T16:00,60.4,30,13,31,0,374,213,161,406.9
2022-10-24T17:00,62.7,18,9,17,0,413,227,186,392.8
2022-10-24T18:00,64.6,23,25,0,0,455,250,205,414.5
2022-10-24T19:00,65.3,71,75,6,0,381,243,138,471.4
2022-10-24T20:00,63.9,89,91,11,0,162,68,94,327.5
2022-10-24T21:00,63,95,99,9,0,93,21,72,110.2
2022-10-24T22:00,61.3,91,99,3,0,28,5,23,51.2
2022-10-24T23:00,60.3,90,97,5,0,0,0,0,0.5
2022-10-25T00:00,59.5,90,93,11,0,0,0,0,0
2022-10-25T01:00,59.2,100,97,28,0,0,0,0,0
2022-10-25T02:00,58.7,42,45,2,0,0,0,0,0
2022-10-25T03:00,58.3,25,28,0,0,0,0,0,0
2022-10-25T04:00,58.4,64,66,7,0,0,0,0,0
2022-10-25T05:00,58.4,92,87,23,0,0,0,0,0
2022-10-25T06:00,58.5,95,92,20,0,0,0,0,0
2022-10-25T07:00,58.1,89,93,9,0,0,0,0,0
2022-10-25T08:00,58.1,41,44,3,0,0,0,0,0
2022-10-25T09:00,58,48,51,2,2,0,0,0,0
2022-10-25T10:00,58,59,65,0,0,0,0,0,0
2022-10-25T11:00,58.2,66,73,0,0,0,0,0,0
2022-10-25T12:00,58.4,57,63,1,0,3,0,3,0
2022-10-25T13:00,59.4,50,55,0,0,55,26,29,77.4
2022-10-25T14:00,61.2,59,65,0,0,135,70,65,198.6
2022-10-25T15:00,62.2,57,63,0,0,174,82,92,206.3
2022-10-25T16:00,63.7,54,60,0,0,221,78,143,164.5
2022-10-25T17:00,64.7,79,86,0,4,227,81,146,141.1
2022-10-25T18:00,66.5,84,93,1,0,272,99,173,153.9
2022-10-25T19:00,67.5,77,85,1,0,272,140,132,222.8
2022-10-25T20:00,67.5,86,96,0,0,247,147,100,319.2
2022-10-25T21:00,67.2,60,67,0,0,179,117,62,409.7
2022-10-25T22:00,65.6,64,71,0,1,55,26,29,303.1
2022-10-25T23:00,64.4,77,85,0,0,0,0,0,1.4
2022-10-26T00:00,64,78,86,0,2,0,0,0,0
2022-10-26T01:00,63,89,99,0,0,0,0,0,0
2022-10-26T02:00,63,77,86,0,0,0,0,0,0
2022-10-26T03:00,62.4,86,95,0,0,0,0,0,0
2022-10-26T04:00,62.2,86,95,0,0,0,0,0,0
2022-10-26T05:00,62.4,76,84,0,0,0,0,0,0
2022-10-26T06:00,62.5,77,85,0,0,0,0,0,0
2022-10-26T07:00,62.6,84,93,0,0,0,0,0,0
2022-10-26T08:00,62.6,86,96,0,0,0,0,0,0
2022-10-26T09:00,62.6,78,86,0,1,0,0,0,0
2022-10-26T10:00,62.6,20,22,0,0,0,0,0,0
2022-10-26T11:00,62.2,37,41,0,1,0,0,0,0
2022-10-26T12:00,62,57,61,0,6,3,1,2,0
2022-10-26T13:00,62.3,37,35,0,19,51,12,39,55.9
2022-10-26T14:00,62.9,7,5,0,9,116,34,82,84.8
2022-10-26T15:00,63.4,2,1,0,3,251,142,109,209.7
2022-10-26T16:00,64.6,38,0,26,75,348,233,115,392.6
2022-10-26T17:00,65.2,49,4,67,17,382,216,166,415.3
2022-10-26T18:00,65.8,47,4,60,25,414,235,179,396.8
2022-10-26T19:00,66.5,41,0,51,34,363,222,141,436.3
2022-10-26T20:00,65.2,44,4,68,0,257,143,114,403.8
2022-10-26T21:00,63.3,80,35,81,0,118,74,44,324
2022-10-26T22:00,61.5,58,21,61,9,17,8,9,160.3
2022-10-26T23:00,60.1,76,31,72,17,0,0,0,0.2
2022-10-27T00:00,59.3,37,17,36,0,0,0,0,0
2022-10-27T01:00,58.7,40,23,32,0,0,0,0,0
2022-10-27T02:00,57.8,90,85,23,0,0,0,0,0
2022-10-27T03:00,57.2,100,100,36,0,0,0,0,0
2022-10-27T04:00,56.7,100,100,42,0,0,0,0,0
2022-10-27T05:00,54.9,97,100,12,0,0,0,0,0
2022-10-27T06:00,52.3,92,100,3,0,0,0,0,0
2022-10-27T07:00,51.3,90,100,0,0,0,0,0,0
2022-10-27T08:00,49.9,90,100,0,0,0,0,0,0
2022-10-27T09:00,48.6,88,98,0,0,0,0,0,0
2022-10-27T10:00,47.7,90,100,0,0,0,0,0,0
2022-10-27T11:00,46.9,89,99,0,0,0,0,0,0
2022-10-27T12:00,46.3,90,100,0,0,2,0,2,0
2022-10-27T13:00,46.2,90,100,0,0,51,8,43,19.1
2022-10-27T14:00,46.9,89,99,0,0,163,63,100,132.2
2022-10-27T15:00,47.5,87,97,0,0,215,50,165,160.8
2022-10-27T16:00,48.6,90,100,0,0,311,124,187,168.7
2022-10-27T17:00,49.6,86,96,0,0,382,171,211,264.3
2022-10-27T18:00,50.6,80,89,0,0,488,314,174,440.5
2022-10-27T19:00,49.8,67,74,0,0,402,228,174,520.8
2022-10-27T20:00,49.5,13,14,0,0,340,217,123,495.4
2022-10-27T21:00,48.3,0,0,0,0,219,154,65,580.8
2022-10-27T22:00,46.4,0,0,0,0,65,41,24,423.5
2022-10-27T23:00,44.7,0,0,0,0,0,0,0,0.2
2022-10-28T00:00,43.5,0,0,0,0,0,0,0,0
2022-10-28T01:00,42.2,0,0,0,0,0,0,0,0
2022-10-28T02:00,41.6,0,0,0,0,0,0,0,0
2022-10-28T03:00,41.4,14,0,0,47,0,0,0,0
2022-10-28T04:00,41.2,28,0,0,92,0,0,0,0
2022-10-28T05:00,41,26,0,0,86,0,0,0,0
2022-10-28T06:00,40.7,28,0,0,94,0,0,0,0
2022-10-28T07:00,39.5,30,0,0,99,0,0,0,0
2022-10-28T08:00,39.1,30,1,0,98,0,0,0,0
2022-10-28T09:00,38.7,30,1,1,95,0,0,0,0
2022-10-28T10:00,38,31,1,0,100,0,0,0,0
2022-10-28T11:00,37.5,34,3,3,99,0,0,0,0
2022-10-28T12:00,37.1,33,2,3,99,4,0,4,0
2022-10-28T13:00,39.7,42,1,19,100,89,32,57,100.8
2022-10-28T14:00,43.1,45,0,25,100,224,103,121,277.8
2022-10-28T15:00,46.6,41,0,18,99,349,212,137,415.5
2022-10-28T16:00,50.1,42,0,20,100,454,283,171,523.5
2022-10-28T17:00,53.1,31,0,2,99,504,322,182,563.3
2022-10-28T18:00,54.9,29,0,0,98,499,329,170,589
2022-10-28T19:00,55.8,31,0,1,100,454,300,154,603.5
2022-10-28T20:00,56,31,0,4,96,356,252,104,637.8
2022-10-28T21:00,54.7,30,0,0,100,190,92,98,518.4
2022-10-28T22:00,52.3,30,0,2,96,44,7,37,184.3
2022-10-28T23:00,50.2,35,0,8,99,0,0,0,0
2022-10-29T00:00,48.5,34,0,7,98,0,0,0,0
2022-10-29T01:00,48.3,42,0,21,98,0,0,0,0
2022-10-29T02:00,47.4,42,0,29,83,0,0,0,0
2022-10-29T03:00,46.4,19,0,7,50,0,0,0,0
2022-10-29T04:00,45.9,5,0,3,11,0,0,0,0
2022-10-29T05:00,44.7,0,0,0,0,0,0,0,0
2022-10-29T06:00,43.6,0,0,0,0,0,0,0,0
2022-10-29T07:00,42,0,0,0,0,0,0,0,0
2022-10-29T08:00,40.8,0,0,0,0,0,0,0,0
2022-10-29T09:00,40.1,0,0,0,0,0,0,0,0
2022-10-29T10:00,39.6,0,0,0,0,0,0,0,0
2022-10-29T11:00,39.1,0,0,0,0,0,0,0,0
2022-10-29T12:00,38.6,0,0,0,0,4,2,2,0
2022-10-29T13:00,40.7,0,0,0,0,108,73,35,288.2
2022-10-29T14:00,47.6,3,0,0,11,276,217,59,623.2
2022-10-29T15:00,52,14,0,0,46,423,352,71,777.8
2022-10-29T16:00,55.4,1,0,0,3,527,450,77,853.7
2022-10-29T17:00,58,0,0,0,0,577,496,81,889.3
2022-10-29T18:00,59.7,0,0,0,0,567,487,80,897.7
2022-10-29T19:00,60.7,0,0,0,0,500,424,76,884.5
2022-10-29T20:00,60.4,0,0,0,0,380,312,68,841.9
2022-10-29T21:00,58.9,0,0,0,0,222,169,53,748.9
2022-10-29T22:00,55.9,0,0,0,0,60,39,21,438.2
2022-10-29T23:00,52.2,0,0,0,0,0,0,0,0
2022-10-30T00:00,50.4,0,0,0,0,0,0,0,0
2022-10-30T01:00,48.7,0,0,0,0,0,0,0,0
2022-10-30T02:00,47.5,0,0,0,0,0,0,0,0
2022-10-30T03:00,46.3,0,0,0,0,0,0,0,0
2022-10-30T04:00,45.1,0,0,0,0,0,0,0,0
2022-10-30T05:00,44.3,0,0,0,0,0,0,0,0
2022-10-30T06:00,43.6,0,0,0,0,0,0,0,0
2022-10-30T07:00,42.6,0,0,0,0,0,0,0,0
2022-10-30T08:00,41.4,0,0,0,0,0,0,0,0
2022-10-30T09:00,40.5,0,0,0,0,0,0,0,0
2022-10-30T10:00,39.8,0,0,0,0,0,0,0,0
2022-10-30T11:00,39.5,2,0,0,7,0,0,0,0
2022-10-30T12:00,39.1,6,0,0,21,4,1,3,0
2022-10-30T13:00,41.6,2,0,0,5,106,70,36,262.1
2022-10-30T14:00,48.4,2,0,0,6,276,216,60,625.6
2022-10-30T15:00,53.6,8,0,0,28,423,346,77,779.9
2022-10-30T16:00,57.1,4,0,0,13,524,434,90,838.8
2022-10-30T17:00,59.5,5,0,0,17,572,478,94,863.3
2022-10-30T18:00,61.1,25,0,0,82,566,483,83,887.6
2022-10-30T19:00,62.1,29,0,0,97,487,394,93,862.4
2022-10-30T20:00,61.4,30,0,0,100,358,263,95,756.8
2022-10-30T21:00,58.6,30,0,0,100,200,123,77,599.2
2022-10-30T22:00,54.4,30,0,0,99,52,24,28,301.2
2022-10-30T23:00,51.9,29,0,0,97,0,0,0,0
2022-10-31T00:00,50.5,30,0,0,100,0,0,0,0
2022-10-31T01:00,49.6,30,0,0,100,0,0,0,0
2022-10-31T02:00,49.1,31,0,1,100,0,0,0,0
2022-10-31T03:00,48.9,61,0,51,100,0,0,0,0
2022-10-31T04:00,48.8,69,0,71,87,0,0,0,0
2022-10-31T05:00,48.6,26,0,23,39,0,0,0,0
2022-10-31T06:00,47.9,19,0,11,42,0,0,0,0
2022-10-31T07:00,46.1,18,0,17,26,0,0,0,0
2022-10-31T08:00,45.6,16,0,18,16,0,0,0,0
2022-10-31T09:00,45,9,0,15,1,0,0,0,0
2022-10-31T10:00,44.8,10,0,6,22,0,0,0,0
2022-10-31T11:00,44.4,48,0,51,57,0,0,0,0
2022-10-31T12:00,44.4,54,0,50,80,3,1,2,0
2022-10-31T13:00,47.1,47,0,39,79,80,32,48,135.3
2022-10-31T14:00,51.3,50,3,34,91,219,134,85,350.6
2022-10-31T15:00,54.9,61,0,78,48,311,196,115,480.2
2022-10-31T16:00,57.6,70,8,88,34,290,142,148,377.4
2022-10-31T17:00,59.5,73,21,62,56,352,152,200,268
2022-10-31T18:00,60.2,56,6,35,97,366,215,151,337.3
2022-10-31T19:00,61,80,5,77,97,341,222,119,445.7
2022-10-31T20:00,60.2,70,8,54,100,200,103,97,375
2022-10-31T21:00,58.5,74,15,52,97,120,51,69,238.8
2022-10-31T22:00,55.9,89,29,55,100,30,9,21,122.7
2022-10-31T23:00,54.4,76,25,39,100,0,0,0,0
2022-11-01T00:00,53.6,80,45,16,100,0,0,0,0
2022-11-01T01:00,54,91,45,34,100,0,0,0,0
2022-11-01T02:00,54.2,98,42,51,100,0,0,0,0
2022-11-01T03:00,54.3,79,28,40,99,0,0,0,0
2022-11-01T04:00,54.3,74,26,36,95,0,0,0,0
2022-11-01T05:00,54.2,66,20,31,97,0,0,0,0
2022-11-01T06:00,54.1,74,12,55,99,0,0,0,0
2022-11-01T07:00,54.4,82,14,69,93,0,0,0,0
2022-11-01T08:00,54.6,80,26,58,72,0,0,0,0
2022-11-01T09:00,54.6,66,28,46,43,0,0,0,0
2022-11-01T10:00,54.5,57,27,53,3,0,0,0,0
2022-11-01T11:00,54.1,35,11,35,13,0,0,0,0
2022-11-01T12:00,54,49,17,32,48,2,0,2,0
2022-11-01T13:00,55,52,16,38,48,53,24,29,87
2022-11-01T14:00,57.2,83,53,41,36,140,63,77,209.3
2022-11-01T15:00,59.3,68,40,35,37,214,70,144,192.6
2022-11-01T16:00,61.4,100,87,26,20,245,125,120,214.7
2022-11-01T17:00,61.4,92,87,22,2,179,37,142,163.4
2022-11-01T18:00,62,92,86,24,0,199,50,149,63.4
2022-11-01T19:00,64.6,75,76,11,0,274,163,111,221.8
2022-11-01T20:00,64.2,94,100,6,0,177,96,81,315.8
2022-11-01T21:00,62.7,93,100,5,0,81,37,44,208.8
2022-11-01T22:00,60.5,93,87,25,0,18,3,15,76.2
2022-11-01T23:00,59.4,79,83,7,0,0,0,0,0
2022-11-02T00:00,58.6,64,71,0,0,0,0,0,0
2022-11-02T01:00,57.4,63,70,0,0,0,0,0,0
2022-11-02T02:00,56.6,79,88,0,0,0,0,0,0
2022-11-02T03:00,55.8,90,100,0,0,0,0,0,0
2022-11-02T04:00,55.2,78,87,0,0,0,0,0,0
2022-11-02T05:00,54.5,71,79,0,0,0,0,0,0
2022-11-02T06:00,53.7,72,80,0,0,0,0,0,0
2022-11-02T07:00,54.2,50,55,0,0,0,0,0,0
2022-11-02T08:00,53.6,67,74,0,0,0,0,0,0
2022-11-02T09:00,53,67,74,0,0,0,0,0,0
2022-11-02T10:00,52.2,88,98,0,0,0,0,0,0
2022-11-02T11:00,51.4,89,98,0,4,0,0,0,0
2022-11-02T12:00,50.8,91,100,0,3,1,0,1,0
2022-11-02T13:00,51,90,100,0,0,40,6,34,22
2022-11-02T14:00,51.8,90,100,0,0,122,18,104,58.7
2022-11-02T15:00,52.9,90,100,0,0,181,8,173,35.1
2022-11-02T16:00,55.1,90,100,0,0,282,97,185,100.3
2022-11-02T17:00,57.1,90,100,0,0,322,159,163,241.9
2022-11-02T18:00,59.7,40,44,0,0,435,302,133,436.2
2022-11-02T19:00,61.5,5,5,0,0,410,291,119,603.8
2022-11-02T20:00,61.7,0,0,0,0,340,271,69,683.3
2022-11-02T21:00,60.4,0,0,0,0,192,141,51,685.4
2022-11-02T22:00,58.3,0,0,0,0,45,27,18,346
2022-11-02T23:00,55.8,0,0,0,0,0,0,0,0
2022-11-03T00:00,53.6,0,0,0,0,0,0,0,0
2022-11-03T01:00,51.6,0,0,0,0,0,0,0,0
2022-11-03T02:00,50.1,0,0,0,0,0,0,0,0
2022-11-03T03:00,49.1,0,0,0,0,0,0,0,0
2022-11-03T04:00,48.9,0,0,0,0,0,0,0,0
2022-11-03T05:00,48.8,0,0,0,0,0,0,0,0
2022-11-03T06:00,48.7,0,0,0,0,0,0,0,0
2022-11-03T07:00,48.7,0,0,0,0,0,0,0,0
2022-11-03T08:00,48.1,0,0,0,0,0,0,0,0
2022-11-03T09:00,47.7,0,0,0,0,0,0,0,0
2022-11-03T10:00,47.4,0,0,0,0,0,0,0,0
2022-11-03T11:00,47.1,0,0,0,0,0,0,0,0
2022-11-03T12:00,47,0,0,0,0,1,0,1,0
2022-11-03T13:00,49.7,0,0,0,0,86,55,31,206.6
2022-11-03T14:00,55.5,0,0,0,0,244,187,57,566.6
2022-11-03T15:00,60.3,0,0,0,0,386,317,69,731
2022-11-03T16:00,63.5,0,0,0,0,487,413,74,816.2
2022-11-03T17:00,65.7,0,0,0,0,534,457,77,855.4
2022-11-03T18:00,67.1,0,0,0,0,523,447,76,862.9
2022-11-03T19:00,67.5,0,0,0,0,455,382,73,843.1
2022-11-03T20:00,66.8,0,0,0,0,338,273,65,790.1
2022-11-03T21:00,63.9,0,0,0,0,188,138,50,684.3
2022-11-03T22:00,59.7,0,0,0,0,42,25,17,330.2
2022-11-03T23:00,57.4,0,0,0,0,0,0,0,0
2022-11-04T00:00,55.9,0,0,0,0,0,0,0,0
2022-11-04T01:00,54.7,0,0,0,0,0,0,0,0
2022-11-04T02:00,53.7,0,0,0,0,0,0,0,0
2022-11-04T03:00,53,0,0,0,0,0,0,0,0
2022-11-04T04:00,52.3,0,0,0,0,0,0,0,0
2022-11-04T05:00,51.8,0,0,0,0,0,0,0,0
2022-11-04T06:00,51.3,0,0,0,0,0,0,0,0
2022-11-04T07:00,50.8,0,0,0,0,0,0,0,0
2022-11-04T08:00,50.4,0,0,0,0,0,0,0,0
2022-11-04T09:00,50.3,0,0,0,0,0,0,0,0
2022-11-04T10:00,50.2,25,0,0,82,0,0,0,0
2022-11-04T11:00,50.2,27,0,0,91,0,0,0,0
2022-11-04T12:00,50.4,26,0,0,86,1,0,1,0
2022-11-04T13:00,52.6,3,0,0,11,73,36,37,133.5
2022-11-04T14:00,56.7,2,0,0,5,223,161,62,446.6
2022-11-04T15:00,60.9,1,0,0,2,358,279,79,646.7
2022-11-04T16:00,64.4,3,0,0,11,463,387,76,749.5
2022-11-04T17:00,66.9,29,0,0,95,512,434,78,816.3
2022-11-04T18:00,68.4,27,1,0,86,502,420,82,825
2022-11-04T19:00,68.9,30,1,0,97,427,334,93,780.9
2022-11-04T20:00,68.2,30,0,0,100,287,163,124,594.1
2022-11-04T21:00,66.2,31,1,0,99,149,65,84,369.9
2022-11-04T22:00,63.9,8,0,0,25,30,5,25,133.2
2022-11-04T23:00,61.9,9,0,0,29,0,0,0,0
2022-11-05T00:00,60.7,16,0,0,54,0,0,0,0
2022-11-05T01:00,60.1,8,0,0,28,0,0,0,0
2022-11-05T02:00,59.5,3,0,0,10,0,0,0,0
2022-11-05T03:00,59.1,1,0,0,2,0,0,0,0
2022-11-05T04:00,58.7,9,0,0,29,0,0,0,0
2022-11-05T05:00,58.4,29,0,0,98,0,0,0,0
2022-11-05T06:00,58,28,1,0,90,0,0,0,0
2022-11-05T07:00,59.4,26,1,0,85,0,0,0,0
2022-11-05T08:00,59.3,34,5,0,99,0,0,0,0
2022-11-05T09:00,59.7,47,19,0,100,0,0,0,0
2022-11-05T10:00,60.6,42,15,0,94,0,0,0,0
2022-11-05T11:00,61.2,50,25,0,91,0,0,0,0
2022-11-05T12:00,61.8,47,21,0,95,1,0,1,0
2022-11-05T13:00,62.7,67,41,0,99,43,11,32,44.9
2022-11-05T14:00,64.2,61,36,0,94,121,30,91,102.6
2022-11-05T15:00,65.8,31,33,2,0,203,78,125,155.6
2022-11-05T16:00,67.5,78,53,2,97,252,73,179,176
2022-11-05T17:00,69.2,77,51,1,100,319,108,211,175.5
2022-11-05T18:00,69.3,38,9,0,100,299,129,170,235.1
2022-11-05T19:00,72.4,41,12,1,99,271,76,195,210.1
2022-11-05T20:00,72,35,6,0,100,221,76,145,192.1
2022-11-05T21:00,70.6,36,7,0,100,106,15,91,145.5
2022-11-05T22:00,69.3,69,0,65,99,22,2,20,29.4
2022-11-05T23:00,68.4,66,1,59,99,0,0,0,0
2022-11-06T00:00,68,51,0,35,99,0,0,0,0
2022-11-06T01:00,67.6,34,0,8,96,0,0,0,0
2022-11-06T02:00,66.9,31,0,10,83,0,0,0,0
2022-11-06T03:00,66.5,28,0,8,76,0,0,0,0
2022-11-06T04:00,66.4,26,0,13,62,0,0,0,0
2022-11-06T05:00,66.3,17,3,16,16,0,0,0,0
2022-11-06T06:00,66.1,31,2,22,52,0,0,0,0
2022-11-06T07:00,67.6,20,1,17,28,0,0,0,0
2022-11-06T08:00,67.3,31,1,9,83,0,0,0,0
2022-11-06T09:00,67.5,61,19,23,99,0,0,0,0
2022-11-06T10:00,67.2,65,9,45,100,0,0,0,0
2022-11-06T11:00,67.2,52,5,30,99,0,0,0,0
2022-11-06T12:00,66.9,55,10,28,98,0,0,0,0
2022-11-06T13:00,66.8,63,21,25,97,28,6,22,0
2022-11-06T14:00,67.3,58,7,39,93,97,33,64,90.5
2022-11-06T15:00,67.5,47,9,40,51,104,23,81,94.9
2022-11-06T16:00,68,33,16,23,16,127,23,104,35.1
2022-11-06T17:00,70.8,20,11,16,0,333,219,114,226.4
2022-11-06T18:00,72.8,26,11,26,0,408,292,116,515.4
2022-11-06T19:00,74.9,30,5,42,0,338,249,89,573.6
2022-11-06T20:00,74.3,46,12,57,2,236,163,73,515.3
2022-11-06T21:00,72.4,27,5,37,0,103,56,47,362.9
2022-11-06T22:00,69.9,70,31,70,0,20,10,10,125.2
2022-11-06T23:00,68.6,41,12,50,0,0,0,0,0
2022-11-07T00:00,67.8,71,34,68,0,0,0,0,0
2022-11-07T01:00,67.1,100,68,75,0,0,0,0,0
2022-11-07T02:00,66.7,100,92,32,0,0,0,0,0
2022-11-07T03:00,66.5,32,20,24,0,0,0,0,0
2022-11-07T04:00,66.1,24,16,16,0,0,0,0,0
2022-11-07T05:00,65.1,19,12,13,0,0,0,0,0
2022-11-07T06:00,64.2,5,1,7,0,0,0,0,0
2022-11-07T07:00,63.2,2,2,1,0,0,0,0,0
2022-11-07T08:00,62.2,4,2,3,0,0,0,0,0
2022-11-07T09:00,61.6,0,0,0,0,0,0,0,0
2022-11-07T10:00,60.2,0,0,0,0,0,0,0,0
2022-11-07T11:00,58.1,0,0,0,0,0,0,0,0
2022-11-07T12:00,56.6,0,0,0,0,0,0,0,0
2022-11-07T13:00,56.7,0,0,0,0,71,44,27,0
2022-11-07T14:00,58.6,0,0,0,0,223,169,54,516.7
2022-11-07T15:00,60.3,0,0,0,0,364,294,70,705.4
2022-11-07T16:00,61.6,0,0,0,0,474,399,75,804.5
2022-11-07T17:00,62.5,0,0,0,0,527,449,78,864.5
2022-11-07T18:00,62.8,0,0,0,0,519,442,77,880.5
2022-11-07T19:00,62.9,0,0,0,0,452,380,72,866.9
2022-11-07T20:00,61.1,0,0,0,0,336,272,64,820.4
2022-11-07T21:00,58.4,2,2,0,0,182,135,47,718.5
2022-11-07T22:00,54.9,2,2,0,0,36,21,15,301.3
2022-11-07T23:00,52.4,3,3,0,0,0,0,0,0
2022-11-08T00:00,50.5,2,2,0,0,0,0,0,0
2022-11-08T01:00,48.5,1,1,0,0,0,0,0,0
2022-11-08T02:00,46.9,1,1,0,0,0,0,0,0
2022-11-08T03:00,45.6,3,3,0,0,0,0,0,0
2022-11-08T04:00,44.7,5,6,0,0,0,0,0,0
2022-11-08T05:00,44,7,8,0,0,0,0,0,0
2022-11-08T06:00,43.6,5,6,0,0,0,0,0,0
2022-11-08T07:00,42.9,5,5,0,0,0,0,0,0
2022-11-08T08:00,42.7,6,7,0,0,0,0,0,0
2022-11-08T09:00,42.4,7,7,0,2,0,0,0,0
2022-11-08T10:00,42.3,6,3,0,12,0,0,0,0
2022-11-08T11:00,42.4,24,4,0,67,0,0,0,0
2022-11-08T12:00,42.3,19,12,0,28,0,0,0,0
2022-11-08T13:00,43.2,17,19,0,0,62,35,27,0
2022-11-08T14:00,44.3,27,30,0,1,193,125,68,404.3
2022-11-08T15:00,45.3,21,23,0,0,317,210,107,513.2
2022-11-08T16:00,46.8,6,7,0,0,444,337,107,630.5
2022-11-08T17:00,47.9,0,0,0,0,513,423,90,781.8
2022-11-08T18:00,48.4,0,0,0,0,512,434,78,857.5
2022-11-08T19:00,47.7,0,0,0,0,445,371,74,858
2022-11-08T20:00,46.6,0,0,0,0,328,263,65,805.5
2022-11-08T21:00,44.8,0,0,0,0,177,128,49,698.2
2022-11-08T22:00,42.6,0,0,0,0,33,19,14,280.2
2022-11-08T23:00,41,0,0,0,0,0,0,0,0
2022-11-09T00:00,39.9,0,0,0,0,0,0,0,0
2022-11-09T01:00,38.8,0,0,0,0,0,0,0,0
2022-11-09T02:00,38.3,0,0,0,0,0,0,0,0
2022-11-09T03:00,37.9,0,0,0,0,0,0,0,0
2022-11-09T04:00,37.5,1,0,0,4,0,0,0,0
2022-11-09T05:00,37,9,0,0,31,0,0,0,0
2022-11-09T06:00,36.5,4,0,0,14,0,0,0,0
2022-11-09T07:00,35.8,4,0,0,13,0,0,0,0
2022-11-09T08:00,35.4,0,0,0,0,0,0,0,0
2022-11-09T09:00,34.9,0,0,0,0,0,0,0,0
2022-11-09T10:00,34.5,0,0,0,0,0,0,0,0
2022-11-09T11:00,34,0,0,0,0,0,0,0,0
2022-11-09T12:00,33.6,0,0,0,0,0,0,0,0
2022-11-09T13:00,35.4,0,0,0,0,68,43,25,0
2022-11-09T14:00,39.6,0,0,0,0,221,167,54,533.2
2022-11-09T15:00,44.4,0,0,0,0,362,295,67,722.1
2022-11-09T16:00,48.6,0,0,0,0,463,389,74,812.3
2022-11-09T17:00,52,2,0,0,6,511,434,77,853.3
2022-11-09T18:00,54.2,1,0,0,3,502,426,76,864.3
2022-11-09T19:00,55.8,1,0,0,2,436,363,73,846.7
2022-11-09T20:00,55.4,0,0,0,0,321,257,64,795.7
2022-11-09T21:00,53.2,0,0,0,0,171,125,46,692.3
2022-11-09T22:00,50,0,0,0,0,31,18,13,268.4
2022-11-09T23:00,48.2,0,0,0,0,0,0,0,0
2022-11-10T00:00,46.9,0,0,0,0,0,0,0,0
2022-11-10T01:00,45.9,0,0,0,0,0,0,0,0
2022-11-10T02:00,45.2,0,0,0,0,0,0,0,0
2022-11-10T03:00,44.7,0,0,0,0,0,0,0,0
2022-11-10T04:00,44.3,0,0,0,0,0,0,0,0
2022-11-10T05:00,44.1,0,0,0,0,0,0,0,0
2022-11-10T06:00,43.8,0,0,0,0,0,0,0,0
2022-11-10T07:00,44,0,0,0,0,0,0,0,0
2022-11-10T08:00,43.7,0,0,0,0,0,0,0,0
2022-11-10T09:00,43.6,0,0,0,0,0,0,0,0
2022-11-10T10:00,43.5,1,0,1,0,0,0,0,0
2022-11-10T11:00,43.4,2,0,4,0,0,0,0,0
2022-11-10T12:00,43.4,7,0,12,0,0,0,0,0
2022-11-10T13:00,45.1,10,0,16,0,61,38,23,0
2022-11-10T14:00,49.2,12,0,20,0,203,145,58,477.4
2022-11-10T15:00,53.6,9,0,15,0,343,273,70,658
2022-11-10T16:00,57.7,8,0,13,0,430,348,82,748.3
2022-11-10T17:00,61,5,0,8,0,477,385,92,763.8
2022-11-10T18:00,63.1,4,0,7,0,481,404,77,799.1
2022-11-10T19:00,64.4,3,0,1,8,419,347,72,815.6
2022-11-10T20:00,63.8,0,0,0,1,307,244,63,766.2
2022-11-10T21:00,61.3,0,0,0,0,164,119,45,667.9
2022-11-10T22:00,57.6,2,0,0,5,28,16,12,251.1
2022-11-10T23:00,55.5,0,0,0,0,0,0,0,0
2022-11-11T00:00,54.2,8,0,0,28,0,0,0,0
2022-11-11T01:00,53.6,26,0,0,88,0,0,0,0
2022-11-11T02:00,53.2,29,0,0,98,0,0,0,0
2022-11-11T03:00,53,30,0,0,100,0,0,0,0
2022-11-11T04:00,52.6,30,0,0,100,0,0,0,0
2022-11-11T05:00,52.2,30,0,0,100,0,0,0,0
2022-11-11T06:00,52.2,32,2,0,100,0,0,0,0
2022-11-11T07:00,53.5,35,6,0,100,0,0,0,0
2022-11-11T08:00,53.7,34,4,0,100,0,0,0,0
2022-11-11T09:00,53.6,32,2,0,100,0,0,0,0
2022-11-11T10:00,53.9,35,6,0,100,0,0,0,0
2022-11-11T11:00,54,37,8,0,100,0,0,0,0
2022-11-11T12:00,54.1,37,8,0,100,0,0,0,0
2022-11-11T13:00,55.8,33,3,0,100,37,4,33,0
2022-11-11T14:00,57.9,42,4,14,100,127,20,107,63
2022-11-11T15:00,60.1,82,1,85,100,176,18,158,67.7
2022-11-11T16:00,58.6,91,1,100,100,161,11,150,36.1
2022-11-11T17:00,58.6,100,12,100,100,108,2,106,13.4
2022-11-11T18:00,58.6,100,30,100,100,53,0,53,1
2022-11-11T19:00,58.8,100,61,100,100,36,0,36,0
2022-11-11T20:00,59.1,100,80,100,100,17,0,17,0
2022-11-11T21:00,59.6,100,98,98,100,8,0,8,0
2022-11-11T22:00,60.5,100,100,87,100,1,0,1,0
2022-11-11T23:00,61.7,100,100,87,99,0,0,0,0
2022-11-12T00:00,62.7,100,90,81,98,0,0,0,0
2022-11-12T01:00,63.2,100,88,73,100,0,0,0,0
2022-11-12T02:00,63.6,100,99,77,100,0,0,0,0
2022-11-12T03:00,63.9,100,98,98,100,0,0,0,0
2022-11-12T04:00,64.2,100,93,98,100,0,0,0,0
2022-11-12T05:00,64.3,100,100,100,100,0,0,0,0
2022-11-12T06:00,64.2,100,100,99,100,0,0,0,0
2022-11-12T07:00,62.6,100,100,100,100,0,0,0,0
2022-11-12T08:00,59.9,100,100,98,100,0,0,0,0
2022-11-12T09:00,57.9,100,100,75,100,0,0,0,0
2022-11-12T10:00,56.4,100,100,3,98,0,0,0,0
2022-11-12T11:00,53.9,90,100,0,0,0,0,0,0
2022-11-12T12:00,52.5,91,100,1,0,0,0,0,0
2022-11-12T13:00,51.6,87,95,2,0,17,0,17,0
2022-11-12T14:00,51.3,90,100,0,0,60,6,54,12.3
2022-11-12T15:00,51.6,90,100,0,0,102,7,95,23.1
2022-11-12T16:00,52,100,100,11,63,136,9,127,18.4
2022-11-12T17:00,52.9,100,100,27,86,198,18,180,28.4
2022-11-12T18:00,53.4,100,97,64,65,208,16,192,27.8
2022-11-12T19:00,54,100,80,39,22,251,95,156,120.1
2022-11-12T20:00,54.1,100,84,55,37,218,119,99,307.9
2022-11-12T21:00,53.4,100,71,77,13,93,26,67,260.7
2022-11-12T22:00,51.5,100,33,99,65,5,0,5,41.7
2022-11-12T23:00,49.6,60,5,88,10,0,0,0,0
2022-11-13T00:00,48,100,54,87,0,0,0,0,0
2022-11-13T01:00,46.8,100,88,98,0,0,0,0,0
2022-11-13T02:00,44.5,100,90,95,0,0,0,0,0
2022-11-13T03:00,43.6,100,100,99,0,0,0,0,0
2022-11-13T04:00,43.1,100,88,85,0,0,0,0,0
2022-11-13T05:00,42.6,100,88,72,0,0,0,0,0
2022-11-13T06:00,42.1,93,67,55,0,0,0,0,0
2022-11-13T07:00,42,67,41,50,0,0,0,0,0
2022-11-13T08:00,42,72,49,46,0,0,0,0,0
2022-11-13T09:00,41.5,57,35,43,0,0,0,0,0
2022-11-13T10:00,41,67,46,43,0,0,0,0,0
2022-11-13T11:00,40.8,100,70,79,0,0,0,0,0
2022-11-13T12:00,40.4,100,59,94,0,0,0,0,0
2022-11-13T13:00,40.6,73,29,78,0,30,10,20,0
2022-11-13T14:00,41.2,68,31,66,0,100,32,68,123.3
2022-11-13T15:00,42.1,71,44,52,0,196,67,129,147.8
2022-11-13T16:00,43.6,81,64,39,0,348,209,139,327.7
2022-11-13T17:00,44.2,98,84,38,0,365,207,158,464.4
2022-11-13T18:00,44.1,92,79,34,0,306,138,168,357.4
2022-11-13T19:00,41.3,94,59,68,0,258,110,148,267.4
2022-11-13T20:00,40.3,75,38,68,0,211,93,118,275.1
2022-11-13T21:00,38.7,53,16,64,0,101,35,66,239.8
2022-11-13T22:00,37,43,8,60,0,17,5,12,69.7
2022-11-13T23:00,36.3,44,11,56,0,0,0,0,0
2022-11-14T00:00,35.6,58,31,50,0,0,0,0,0
2022-11-14T01:00,35.4,59,33,49,0,0,0,0,0
2022-11-14T02:00,35.1,55,38,35,0,0,0,0,0
2022-11-14T03:00,34.5,61,38,44,0,0,0,0,0
2022-11-14T04:00,34.6,54,45,22,0,0,0,0,0
2022-11-14T05:00,34.4,48,39,21,0,0,0,0,0
2022-11-14T06:00,34.2,63,51,29,0,0,0,0,0
2022-11-14T07:00,33.8,67,56,27,0,0,0,0,0
2022-11-14T08:00,33.6,70,60,27,0,0,0,0,0
2022-11-14T09:00,33.4,78,66,31,0,0,0,0,0
2022-11-14T10:00,33.3,81,61,43,0,0,0,0,0
2022-11-14T11:00,33.4,75,53,46,0,0,0,0,0
2022-11-14T12:00,33.3,89,61,45,24,0,0,0,0
2022-11-14T13:00,34,100,68,48,69,39,16,23,0
2022-11-14T14:00,35.6,100,75,48,61,145,74,71,258.6
2022-11-14T15:00,36.7,100,89,47,5,196,78,118,274.8
2022-11-14T16:00,37.7,100,96,24,0,217,63,154,176.6
2022-11-14T17:00,38.3,100,96,21,3,232,68,164,143.7
2022-11-14T18:00,38.9,95,100,4,8,195,6,189,78.4
2022-11-14T19:00,38.5,91,100,0,4,137,0,137,1.6
2022-11-14T20:00,38.2,94,100,0,14,99,7,92,10.9
2022-11-14T21:00,37.9,92,100,2,4,43,1,42,14.9
2022-11-14T22:00,37.4,95,100,6,3,8,0,8,0.6
2022-11-14T23:00,36.9,84,92,2,0,0,0,0,0
2022-11-15T00:00,36.3,81,89,0,2,0,0,0,0
2022-11-15T01:00,35.6,81,90,0,1,0,0,0,0
2022-11-15T02:00,35.6,79,85,2,3,0,0,0,0
2022-11-15T03:00,35.1,69,74,2,4,0,0,0,0
2022-11-15T04:00,34.4,75,82,2,0,0,0,0,0
2022-11-15T05:00,35.2,79,79,1,25,0,0,0,0
2022-11-15T06:00,35.6,86,81,3,38,0,0,0,0
2022-11-15T07:00,35.3,80,72,5,41,0,0,0,0
2022-11-15T08:00,35.1,89,78,7,49,0,0,0,0
2022-11-15T09:00,33.2,85,73,6,52,0,0,0,0
2022-11-15T10:00,33.2,100,75,7,95,0,0,0,0
2022-11-15T11:00,33,72,58,4,58,0,0,0,0
2022-11-15T12:00,33.1,81,51,8,100,0,0,0,0
2022-11-15T13:00,34.1,75,39,16,100,30,2,28,0
2022-11-15T14:00,35.8,87,17,69,100,107,18,89,50.7
2022-11-15T15:00,37,100,15,100,100,177,32,145,87.8
2022-11-15T16:00,38.2,100,65,96,100,207,21,186,71.8
2022-11-15T17:00,38.4,100,73,88,100,154,0,154,21.9
2022-11-15T18:00,38.8,100,46,83,100,170,8,162,6.3
2022-11-15T19:00,38.1,77,0,79,97,113,9,104,19.2
2022-11-15T20:00,38.1,84,0,91,99,123,12,111,28.9
2022-11-15T21:00,37.7,83,0,89,100,73,11,62,51.6
2022-11-15T22:00,36.3,90,0,100,100,7,0,7,19.6
2022-11-15T23:00,35.2,94,5,99,100,0,0,0,0
2022-11-16T00:00,34.7,100,58,100,100,0,0,0,0
2022-11-16T01:00,34.2,100,98,100,41,0,0,0,0
2022-11-16T02:00,34.2,100,93,96,0,0,0,0,0
2022-11-16T03:00,34.3,100,94,95,0,0,0,0,0
2022-11-16T04:00,34.8,100,98,96,0,0,0,0,0
2022-11-16T05:00,35.3,100,99,91,0,0,0,0,0
2022-11-16T06:00,35.2,100,100,95,0,0,0,0,0
2022-11-16T07:00,35.5,100,100,100,0,0,0,0,0
2022-11-16T08:00,35.9,100,100,94,0,0,0,0,0
2022-11-16T09:00,36.2,100,100,100,0,0,0,0,0
2022-11-16T10:00,36.2,100,100,100,0,0,0,0,0
2022-11-16T11:00,36.2,100,100,100,0,0,0,0,0
2022-11-16T12:00,36.3,100,92,98,0,0,0,0,0
2022-11-16T13:00,36.5,100,77,74,0,8,3,5,0
2022-11-16T14:00,37.1,100,84,42,0,46,9,37,35.9
2022-11-16T15:00,39.7,100,85,42,0,134,50,84,86.1
2022-11-16T16:00,42.1,55,42,29,0,250,105,145,201.7
2022-11-16T17:00,43,37,31,15,0,232,46,186,171.1
2022-11-16T18:00,43.1,50,41,22,0,239,83,156,113.5
2022-11-16T19:00,43.7,53,38,32,0,350,243,107,387.6
2022-11-16T20:00,43.1,30,16,26,0,235,151,84,557.3
2022-11-16T21:00,41.6,50,23,48,0,111,61,50,412.3
2022-11-16T22:00,39.4,65,27,68,0,14,5,9,109.6
2022-11-16T23:00,37.7,100,69,91,0,0,0,0,0
2022-11-17T00:00,36.9,100,95,98,0,0,0,0,0
2022-11-17T01:00,36.8,100,97,98,0,0,0,0,0
2022-11-17T02:00,36.4,100,94,93,0,0,0,0,0
2022-11-17T03:00,36,100,77,87,0,0,0,0,0
2022-11-17T04:00,35.6,96,57,75,0,0,0,0,0
2022-11-17T05:00,35.2,100,73,82,0,0,0,0,0
2022-11-17T06:00,35.2,89,61,56,0,0,0,0,0
2022-11-17T07:00,34.9,71,47,47,0,0,0,0,0
2022-11-17T08:00,34.6,69,41,54,0,0,0,0,0
2022-11-17T09:00,34.4,77,47,58,0,0,0,0,0
2022-11-17T10:00,34.4,55,6,83,0,0,0,0,0
2022-11-17T11:00,34.2,59,8,87,0,0,0,0,0
2022-11-17T12:00,34.6,58,10,82,0,0,0,0,0
2022-11-17T13:00,35.4,61,12,83,0,27,10,17,0
2022-11-17T14:00,36.4,72,22,87,0,137,59,78,198.7
2022-11-17T15:00,37.7,71,24,82,0,247,118,129,304.2
2022-11-17T16:00,38.8,62,45,36,0,333,176,157,386.9
2022-11-17T17:00,39,51,37,29,0,281,84,197,293.2
2022-11-17T18:00,38.7,53,44,22,0,308,140,168,220.9
2022-11-17T19:00,38.3,37,26,22,0,333,210,123,415.5
2022-11-17T20:00,37.6,51,34,34,0,226,124,102,471.2
2022-11-17T21:00,36.4,38,35,11,0,100,41,59,311.6
2022-11-17T22:00,35.1,86,68,42,0,16,7,9,76.7
2022-11-17T23:00,34.2,30,22,17,0,0,0,0,0
2022-11-18T00:00,33.5,20,14,13,0,0,0,0,0
2022-11-18T01:00,33.3,22,15,14,0,0,0,0,0
2022-11-18T02:00,33.1,60,14,73,12,0,0,0,0
2022-11-18T03:00,33.1,93,31,99,18,0,0,0,0
2022-11-18T04:00,33.3,91,36,97,0,0,0,0,0
2022-11-18T05:00,33.7,84,31,94,0,0,0,0,0
2022-11-18T06:00,33.8,77,23,94,0,0,0,0,0
2022-11-18T07:00,33.5,80,28,91,0,0,0,0,0
2022-11-18T08:00,33.1,36,17,34,0,0,0,0,0
2022-11-18T09:00,32.4,11,5,11,0,0,0,0,0
2022-11-18T10:00,31.7,19,5,24,0,0,0,0,0
2022-11-18T11:00,31.3,18,7,20,0,0,0,0,0
2022-11-18T12:00,31,37,28,20,0,0,0,0,0
2022-11-18T13:00,31.6,42,30,25,0,43,26,17,0
2022-11-18T14:00,33.3,49,32,33,0,187,139,48,509.4
2022-11-18T15:00,35.1,86,59,54,0,308,218,90,646.1
2022-11-18T16:00,36.3,68,41,51,0,361,254,107,623.5
2022-11-18T17:00,37,66,18,83,0,348,193,155,511.2
2022-11-18T18:00,36.9,81,28,93,0,273,108,165,317
2022-11-18T19:00,37.6,79,24,95,0,258,104,154,237.5
2022-11-18T20:00,37.6,75,21,93,0,201,82,119,263.9
2022-11-18T21:00,36.5,77,24,93,0,100,34,66,235.1
2022-11-18T22:00,34.5,65,3,97,14,11,2,9,57.7
2022-11-18T23:00,33.9,72,6,96,29,0,0,0,0
2022-11-19T00:00,33.6,49,2,74,9,0,0,0,0
2022-11-19T01:00,32.6,3,1,3,0,0,0,0,0
2022-11-19T02:00,31.5,1,1,0,0,0,0,0,0
2022-11-19T03:00,30.8,5,3,3,0,0,0,0,0
2022-11-19T04:00,30.4,0,0,0,0,0,0,0,0
2022-11-19T05:00,29.9,0,0,0,0,0,0,0,0
2022-11-19T06:00,29.6,1,0,1,0,0,0,0,0
2022-11-19T07:00,29.3,9,1,14,0,0,0,0,0
2022-11-19T08:00,28.9,6,0,10,0,0,0,0,0
2022-11-19T09:00,28.7,2,1,1,0,0,0,0,0
2022-11-19T10:00,28.5,18,17,5,0,0,0,0,0
2022-11-19T11:00,28.4,8,5,5,0,0,0,0,0
2022-11-19T12:00,28.2,20,13,13,0,0,0,0,0
2022-11-19T13:00,28.8,17,12,11,0,42,25,17,0
2022-11-19T14:00,30.4,30,29,7,0,186,137,49,506.4
2022-11-19T15:00,32,68,67,6,12,322,249,73,695.8
2022-11-19T16:00,33.3,100,82,36,31,398,289,109,724.5
2022-11-19T17:00,33.8,100,96,89,65,368,193,175,553.4
2022-11-19T18:00,34.1,100,98,91,28,344,148,196,362.7
2022-11-19T19:00,34.2,100,100,93,0,268,103,165,283.3
2022-11-19T20:00,34.2,100,100,95,0,222,102,120,291.6
2022-11-19T21:00,33.4,100,82,69,0,120,51,69,321.8
2022-11-19T22:00,31.9,34,6,47,0,17,6,11,90.4
2022-11-19T23:00,31.2,52,0,81,11,0,0,0,0
2022-11-20T00:00,31,72,0,87,66,0,0,0,0
2022-11-20T01:00,31.4,85,0,96,91,0,0,0,0
2022-11-20T02:00,31.7,89,0,99,97,0,0,0,0
2022-11-20T03:00,31.8,61,0,99,6,0,0,0,0
2022-11-20T04:00,31.7,60,1,98,0,0,0,0,0
2022-11-20T05:00,31.5,59,8,87,0,0,0,0,0
2022-11-20T06:00,31.3,56,10,78,0,0,0,0,0
2022-11-20T07:00,30,64,16,82,0,0,0,0,0
2022-11-20T08:00,29.4,71,18,91,0,0,0,0,0
2022-11-20T09:00,28.8,62,20,73,0,0,0,0,0
2022-11-20T10:00,27.9,50,21,52,0,0,0,0,0
2022-11-20T11:00,27.2,30,17,25,0,0,0,0,0
2022-11-20T12:00,26.5,33,7,45,0,0,0,0,0
2022-11-20T13:00,26.5,26,6,35,0,34,16,18,0
2022-11-20T14:00,27.2,28,4,41,0,159,97,62,349.9
2022-11-20T15:00,28.4,42,9,56,0,296,205,91,540.6
2022-11-20T16:00,29.9,39,11,49,0,378,263,115,630.6
2022-11-20T17:00,30.6,52,22,54,0,372,233,139,570.4
2022-11-20T18:00,31.2,77,47,58,0,351,208,143,482.6
2022-11-20T19:00,29.9,100,84,89,0,300,141,159,403.8
2022-11-20T20:00,29.4,100,85,94,0,223,112,111,366.2
2022-11-20T21:00,28.6,88,48,74,0,90,21,69,247.7
2022-11-20T22:00,27.8,100,61,87,0,14,5,9,36.1
2022-11-20T23:00,26.9,91,59,63,0,0,0,0,0
2022-11-21T00:00,25.9,66,48,38,0,0,0,0,0
2022-11-21T01:00,24.6,54,35,37,0,0,0,0,0
2022-11-21T02:00,24.4,85,58,54,0,0,0,0,0
2022-11-21T03:00,24.2,96,69,56,0,0,0,0,0
2022-11-21T04:00,23.9,80,59,45,0,0,0,0,0
2022-11-21T05:00,23.6,51,41,24,0,0,0,0,0
2022-11-21T06:00,23.4,33,34,4,0,0,0,0,0
2022-11-21T07:00,22.8,67,74,1,0,0,0,0,0
2022-11-21T08:00,22.9,86,95,1,0,0,0,0,0
2022-11-21T09:00,23.1,75,83,0,0,0,0,0,0
2022-11-21T10:00,23.4,48,53,0,0,0,0,0,0
2022-11-21T11:00,23.4,20,17,0,15,0,0,0,0
2022-11-21T12:00,23.4,16,1,4,41,0,0,0,0
2022-11-21T13:00,24.4,23,0,1,74,31,13,18,0
2022-11-21T14:00,27.1,53,0,43,91,135,45,90,204.2
2022-11-21T15:00,30.9,62,0,58,92,276,164,112,353.3
2022-11-21T16:00,34.6,71,0,68,99,354,201,153,505.4
2022-11-21T17:00,37.2,64,0,57,98,353,171,182,430.1
2022-11-21T18:00,39,57,0,55,79,345,162,183,361.2
2022-11-21T19:00,39.4,59,0,74,49,312,161,151,385.3
2022-11-21T20:00,38.9,34,0,56,0,193,97,96,365.5
2022-11-21T21:00,38.4,19,0,32,0,103,57,46,331
2022-11-21T22:00,37.2,7,0,9,5,15,8,7,99.6
2022-11-21T23:00,36.4,1,0,2,0,0,0,0,0
2022-11-22T00:00,35.7,20,6,25,0,0,0,0,0
2022-11-22T01:00,35.3,47,22,45,0,0,0,0,0
2022-11-22T02:00,34.6,54,34,39,0,0,0,0,0
2022-11-22T03:00,34.9,30,27,10,0,0,0,0,0
2022-11-22T04:00,34.8,48,41,18,0,0,0,0,0
2022-11-22T05:00,34.5,40,41,6,0,0,0,0,0
2022-11-22T06:00,34.2,36,39,1,0,0,0,0,0
2022-11-22T07:00,35.1,28,31,0,0,0,0,0,0
2022-11-22T08:00,34.5,31,34,0,0,0,0,0,0
2022-11-22T09:00,34.2,34,38,0,0,0,0,0,0
2022-11-22T10:00,33.4,68,76,0,0,0,0,0,0
2022-11-22T11:00,33.3,61,68,0,0,0,0,0,0
2022-11-22T12:00,32.8,40,44,0,0,0,0,0,0
2022-11-22T13:00,33,24,27,0,0,28,14,14,0
2022-11-22T14:00,36.8,10,11,0,0,153,99,54,355.3
2022-11-22T15:00,38.8,9,8,0,5,275,189,86,534
2022-11-22T16:00,41,24,9,0,54,380,286,94,637.1
2022-11-22T17:00,42.9,33,6,0,93,426,322,104,716.4
2022-11-22T18:00,44.1,36,3,8,95,370,214,156,604.1
2022-11-22T19:00,45.8,32,4,3,87,285,125,160,381.2
2022-11-22T20:00,45.9,19,1,2,57,244,155,89,411.6
2022-11-22T21:00,43.9,34,0,44,24,125,78,47,512.6
2022-11-22T22:00,41,20,0,34,0,14,7,7,127.1
2022-11-22T23:00,39.2,1,0,1,0,0,0,0,0
2022-11-23T00:00,38,0,0,0,0,0,0,0,0
2022-11-23T01:00,37.4,5,0,2,12,0,0,0,0
2022-11-23T02:00,37,10,0,11,10,0,0,0,0
2022-11-23T03:00,36.8,21,0,35,0,0,0,0,0
2022-11-23T04:00,36.5,43,0,72,0,0,0,0,0
2022-11-23T05:00,36.3,35,0,59,0,0,0,0,0
2022-11-23T06:00,36.1,35,0,59,0,0,0,0,0
2022-11-23T07:00,37.2,37,0,62,0,0,0,0,0
2022-11-23T08:00,36.8,22,1,35,0,0,0,0,0
2022-11-23T09:00,35.9,20,5,26,0,0,0,0,0
2022-11-23T10:00,35.1,20,8,22,0,0,0,0,0
2022-11-23T11:00,34.6,12,8,8,0,0,0,0,0
2022-11-23T12:00,34,4,4,1,0,0,0,0,0
2022-11-23T13:00,34.3,3,3,0,0,29,15,14,0
2022-11-23T14:00,39.1,2,2,0,0,157,110,47,399.4
2022-11-23T15:00,41.8,1,1,0,0,281,207,74,597.4
2022-11-23T16:00,43.6,7,8,0,0,387,313,74,706.4
2022-11-23T17:00,44.9,20,22,0,0,410,322,88,747.9
2022-11-23T18:00,45.8,20,21,1,0,399,297,102,696.4
2022-11-23T19:00,46.4,69,75,2,0,312,211,101,605.5
2022-11-23T20:00,45.8,31,34,0,0,230,143,87,507.7
2022-11-23T21:00,44.2,9,10,0,0,118,71,47,464.8
2022-11-23T22:00,41.6,29,7,0,76,14,6,8,112.9
2022-11-23T23:00,42.1,29,4,0,85,0,0,0,0
2022-11-24T00:00,41.4,18,0,0,61,0,0,0,0
2022-11-24T01:00,40.3,2,0,0,6,0,0,0,0
2022-11-24T02:00,39.4,0,0,0,0,0,0,0,0
2022-11-24T03:00,38.6,0,0,0,0,0,0,0,0
2022-11-24T04:00,35.7,0,0,0,0,0,0,0,0
2022-11-24T05:00,32.8,0,0,0,0,0,0,0,0
2022-11-24T06:00,33,0,0,0,0,0,0,0,0
2022-11-24T07:00,33.6,0,0,0,0,0,0,0,0
2022-11-24T08:00,33.7,0,0,0,0,0,0,0,0
2022-11-24T09:00,33.6,0,0,0,0,0,0,0,0
2022-11-24T10:00,33.5,0,0,0,0,0,0,0,0
2022-11-24T11:00,33.5,0,0,0,0,0,0,0,0
2022-11-24T12:00,33.3,0,0,0,0,0,0,0,0
2022-11-24T13:00,34.3,0,0,0,0,29,17,12,0
2022-11-24T14:00,38.7,17,0,0,58,159,114,45,434.7
2022-11-24T15:00,44.1,29,0,0,95,294,232,62,659.1
2022-11-24T16:00,47.8,29,0,0,98,380,288,92,728.9
2022-11-24T17:00,49.9,30,0,0,100,395,249,146,636.7
2022-11-24T18:00,50.8,25,0,0,82,377,221,156,521.1
2022-11-24T19:00,50.5,22,0,0,72,339,217,122,526.8
2022-11-24T20:00,49.1,12,0,0,40,249,164,85,565.2
2022-11-24T21:00,45.4,19,0,0,62,120,72,48,514
2022-11-24T22:00,41.6,22,0,0,73,13,4,9,108.4
2022-11-24T23:00,40.1,14,0,0,48,0,0,0,0
2022-11-25T00:00,39.1,28,0,0,92,0,0,0,0
2022-11-25T01:00,38.8,30,0,0,99,0,0,0,0
2022-11-25T02:00,39,31,0,2,100,0,0,0,0
2022-11-25T03:00,39.8,37,0,12,100,0,0,0,0
2022-11-25T04:00,40.5,40,0,17,99,0,0,0,0
2022-11-25T05:00,40.7,49,0,31,100,0,0,0,0
2022-11-25T06:00,40.6,84,0,90,100,0,0,0,0
2022-11-25T07:00,42.9,90,0,100,100,0,0,0,0
2022-11-25T08:00,43.4,89,0,100,96,0,0,0,0
2022-11-25T09:00,42.8,94,7,96,99,0,0,0,0
2022-11-25T10:00,39.7,100,86,96,96,0,0,0,0
2022-11-25T11:00,40.3,100,97,95,16,0,0,0,0
2022-11-25T12:00,40.7,100,100,85,20,0,0,0,0
2022-11-25T13:00,41.4,100,100,84,51,5,0,5,0
2022-11-25T14:00,42.4,100,100,90,94,14,0,14,0
2022-11-25T15:00,43.4,100,60,66,94,18,0,18,0
2022-11-25T16:00,43.7,100,69,40,80,58,4,54,0.7
2022-11-25T17:00,43.8,85,64,10,71,189,64,125,74.2
2022-11-25T18:00,43.3,89,63,24,61,215,86,129,170.1
2022-11-25T19:00,44.7,57,57,5,9,250,126,124,260.3
2022-11-25T20:00,44,81,72,27,0,183,110,73,362.9
2022-11-25T21:00,42.6,84,65,42,0,81,37,44,312.5
2022-11-25T22:00,41.3,56,43,29,0,8,3,5,54.7
2022-11-25T23:00,40.2,50,31,37,0,0,0,0,0
2022-11-26T00:00,39.3,55,39,33,0,0,0,0,0
2022-11-26T01:00,38.7,56,43,28,0,0,0,0,0
2022-11-26T02:00,38.1,65,55,25,0,0,0,0,0
2022-11-26T03:00,37.5,53,44,23,0,0,0,0,0
2022-11-26T04:00,37.1,63,60,15,0,0,0,0,0
2022-11-26T05:00,36.7,71,70,13,0,0,0,0,0
2022-11-26T06:00,36.5,73,81,0,0,0,0,0,0
2022-11-26T07:00,37.6,68,76,0,0,0,0,0,0
2022-11-26T08:00,37.1,52,58,0,0,0,0,0,0
2022-11-26T09:00,37.2,40,44,0,0,0,0,0,0
2022-11-26T10:00,36.7,23,26,0,0,0,0,0,0
2022-11-26T11:00,36.8,14,15,0,0,0,0,0,0
2022-11-26T12:00,36.2,6,7,0,0,0,0,0,0
2022-11-26T13:00,36.7,1,1,0,0,23,12,11,0
2022-11-26T14:00,39.3,3,0,0,10,147,101,46,371.7
2022-11-26T15:00,42.7,3,1,0,6,278,219,59,619.7
2022-11-26T16:00,46.1,8,2,0,21,383,316,67,749.6
2022-11-26T17:00,49,13,5,0,28,433,363,70,811.9
2022-11-26T18:00,51.2,0,0,0,0,428,358,70,826.5
2022-11-26T19:00,53.1,0,0,0,0,368,302,66,808.9
2022-11-26T20:00,52.9,0,0,0,0,262,204,58,752.1
2022-11-26T21:00,50.3,0,0,0,0,124,86,38,635.4
2022-11-26T22:00,47.3,0,0,0,0,12,6,6,125.5
2022-11-26T23:00,45.9,0,0,0,0,0,0,0,0
2022-11-27T00:00,44.7,0,0,0,0,0,0,0,0
2022-11-27T01:00,43.6,0,0,0,0,0,0,0,0
2022-11-27T02:00,42.6,4,0,0,14,0,0,0,0
2022-11-27T03:00,41.6,6,0,0,20,0,0,0,0
2022-11-27T04:00,40.6,28,0,0,94,0,0,0,0
2022-11-27T05:00,39.7,30,0,0,100,0,0,0,0
2022-11-27T06:00,39.4,30,0,0,100,0,0,0,0
2022-11-27T07:00,40,30,0,0,100,0,0,0,0
2022-11-27T08:00,39.5,30,0,0,100,0,0,0,0
2022-11-27T09:00,39.4,30,0,0,100,0,0,0,0
2022-11-27T10:00,39.8,30,0,0,100,0,0,0,0
2022-11-27T11:00,39.9,30,0,0,100,0,0,0,0
2022-11-27T12:00,40.1,21,0,0,69,0,0,0,0
2022-11-27T13:00,41.3,8,0,4,18,11,0,11,0
2022-11-27T14:00,44.1,64,0,58,97,83,13,70,34.5
2022-11-27T15:00,46.5,72,0,75,90,114,16,98,64.3
2022-11-27T16:00,47.3,85,0,97,90,106,13,93,38.6
2022-11-27T17:00,49.5,85,0,92,98,135,46,89,71.9
2022-11-27T18:00,48.2,100,42,100,96,82,1,81,57.4
2022-11-27T19:00,44.6,100,100,97,43,41,0,41,0.1
2022-11-27T20:00,45.3,100,87,83,34,54,16,38,29.5
2022-11-27T21:00,45.5,100,80,82,41,15,0,15,30.5
2022-11-27T22:00,46,74,55,16,48,3,0,3,0
2022-11-27T23:00,46.7,100,76,86,85,0,0,0,0
2022-11-28T00:00,47.3,100,44,89,100,0,0,0,0
2022-11-28T01:00,48.1,100,97,100,100,0,0,0,0
2022-11-28T02:00,49,100,91,99,100,0,0,0,0
2022-11-28T03:00,49.6,100,91,68,26,0,0,0,0
2022-11-28T04:00,50.4,100,100,49,0,0,0,0,0
2022-11-28T05:00,49.9,100,100,87,0,0,0,0,0
2022-11-28T06:00,48.2,100,100,81,26,0,0,0,0
2022-11-28T07:00,44.7,100,100,58,29,0,0,0,0
2022-11-28T08:00,42.3,100,100,46,17,0,0,0,0
2022-11-28T09:00,40.9,100,100,74,2,0,0,0,0
2022-11-28T10:00,40.3,100,100,61,4,0,0,0,0
2022-11-28T11:00,39.6,100,100,82,20,0,0,0,0
2022-11-28T12:00,39.2,100,100,87,54,0,0,0,0
2022-11-28T13:00,38.9,100,97,85,61,5,0,5,0
2022-11-28T14:00,39.1,100,99,81,16,30,2,28,5.1
2022-11-28T15:00,39,100,99,33,0,58,3,55,9.9
2022-11-28T16:00,39.2,94,100,6,0,95,5,90,11
2022-11-28T17:00,38.8,90,100,0,0,85,8,77,15.9
2022-11-28T18:00,38.9,90,100,0,0,106,6,100,16.9
2022-11-28T19:00,39.3,90,100,0,0,68,1,67,8.3
2022-11-28T20:00,38.8,90,100,0,0,51,0,51,0.4
2022-11-28T21:00,38.2,90,100,0,0,29,4,25,14
2022-11-28T22:00,37.3,90,100,0,0,3,0,3,5.8
2022-11-28T23:00,36.9,87,97,0,0,0,0,0,0
2022-11-29T00:00,36.3,79,88,0,0,0,0,0,0
2022-11-29T01:00,35.6,77,85,0,0,0,0,0,0
2022-11-29T02:00,35.3,88,98,0,0,0,0,0,0
2022-11-29T03:00,35.1,88,98,0,0,0,0,0,0
2022-11-29T04:00,34.9,89,99,0,0,0,0,0,0
2022-11-29T05:00,34.7,88,98,0,0,0,0,0,0
2022-11-29T06:00,34.6,89,98,0,1,0,0,0,0
2022-11-29T07:00,35,85,91,0,11,0,0,0,0
2022-11-29T08:00,34.9,90,91,0,27,0,0,0,0
2022-11-29T09:00,34.5,87,92,0,15,0,0,0,0
2022-11-29T10:00,34.5,100,93,1,79,0,0,0,0
2022-11-29T11:00,34.5,93,89,0,43,0,0,0,0
2022-11-29T12:00,34.6,99,77,0,100,0,0,0,0
2022-11-29T13:00,35,95,72,0,100,11,2,9,0
2022-11-29T14:00,36,97,74,0,100,68,17,51,66.4
2022-11-29T15:00,37.8,86,63,0,98,160,41,119,106.6
2022-11-29T16:00,40,89,66,0,99,278,140,138,242.1
2022-11-29T17:00,41.9,77,62,0,72,337,205,132,423.8
2022-11-29T18:00,43.4,100,95,0,91,353,218,135,510.3
2022-11-29T19:00,44.2,100,87,0,100,231,71,160,359.3
2022-11-29T20:00,44,68,43,0,98,122,14,108,104.8
2022-11-29T21:00,42.7,76,51,0,99,65,14,51,65.9
2022-11-29T22:00,41.4,96,74,0,98,8,1,7,20
2022-11-29T23:00,40.4,73,49,0,97,0,0,0,0
2022-11-30T00:00,39.9,46,24,2,77,0,0,0,0
2022-11-30T01:00,38.8,33,7,1,86,0,0,0,0
2022-11-30T02:00,38.2,31,6,0,85,0,0,0,0
2022-11-30T03:00,37.8,17,3,0,49,0,0,0,0
2022-11-30T04:00,37.8,20,5,19,15,0,0,0,0
2022-11-30T05:00,37.8,43,1,70,0,0,0,0,0
2022-11-30T06:00,37.9,1,1,0,0,0,0,0,0
2022-11-30T07:00,38.2,5,1,4,6,0,0,0,0
2022-11-30T08:00,38.3,38,4,8,100,0,0,0,0
2022-11-30T09:00,38.8,44,2,20,100,0,0,0,0
2022-11-30T10:00,39.6,75,15,53,100,0,0,0,0
2022-11-30T11:00,41,100,15,99,100,0,0,0,0
2022-11-30T12:00,41.8,100,49,99,100,0,0,0,0
2022-11-30T13:00,42.3,100,94,100,100,4,0,4,0
2022-11-30T14:00,43.3,100,97,98,100,21,0,21,0
2022-11-30T15:00,44.7,100,99,97,96,40,0,40,0
2022-11-30T16:00,45.4,100,99,100,20,51,0,51,0
2022-11-30T17:00,45.8,100,100,100,36,78,19,59,23.6
2022-11-30T18:00,46.9,100,100,99,18,26,0,26,24.3
2022-11-30T19:00,47.7,100,88,94,24,27,0,27,0
2022-11-30T20:00,45,100,91,96,0,18,0,18,0
2022-11-30T21:00,40.5,60,53,21,0,39,16,23,52.8
2022-11-30T22:00,38.6,24,3,36,0,7,2,5,23.9
2022-11-30T23:00,37.3,18,14,9,0,0,0,0,0
2022-12-01T00:00,36.9,91,94,11,0,0,0,0,0
2022-12-01T01:00,37.1,93,94,14,0,0,0,0,0
2022-12-01T02:00,36.1,91,80,31,0,0,0,0,0
2022-12-01T03:00,35.3,71,56,35,0,0,0,0,0
2022-12-01T04:00,34.4,60,41,39,0,0,0,0,0
2022-12-01T05:00,33.6,62,21,72,0,0,0,0,0
2022-12-01T06:00,33.1,37,14,41,0,0,0,0,0
2022-12-01T07:00,33,16,3,22,0,0,0,0,0
2022-12-01T08:00,32.3,7,5,4,0,0,0,0,0
2022-12-01T09:00,31.8,7,4,5,0,0,0,0,0
2022-12-01T10:00,31.6,23,18,12,0,0,0,0,0
2022-12-01T11:00,31.3,58,50,22,0,0,0,0,0
2022-12-01T12:00,31.7,76,74,16,0,0,0,0,0
2022-12-01T13:00,32.3,100,84,53,0,16,7,9,0
2022-12-01T14:00,33.7,100,84,77,0,101,42,59,204.9
2022-12-01T15:00,34.9,100,88,76,0,157,41,116,192
2022-12-01T16:00,36.1,100,88,62,0,219,58,161,135.5
2022-12-01T17:00,37.1,82,67,36,0,282,111,171,204.7
2022-12-01T18:00,37.6,74,76,10,0,279,115,164,269.7
2022-12-01T19:00,37,91,88,19,0,245,111,134,288.6
2022-12-01T20:00,36.2,49,52,3,0,174,62,112,254.3
2022-12-01T21:00,35.1,24,27,0,0,104,59,45,310.2
2022-12-01T22:00,33.5,59,66,0,0,9,4,5,81.2
2022-12-01T23:00,32.9,68,75,0,0,0,0,0,0
2022-12-02T00:00,32.6,59,66,0,0,0,0,0,0
2022-12-02T01:00,31.4,55,53,12,0,0,0,0,0
2022-12-02T02:00,30.7,26,28,1,0,0,0,0,0
2022-12-02T03:00,30.5,16,18,0,0,0,0,0,0
2022-12-02T04:00,30.4,8,9,0,0,0,0,0,0
2022-12-02T05:00,30.2,4,4,0,0,0,0,0,0
2022-12-02T06:00,29.7,5,6,0,0,0,0,0,0
2022-12-02T07:00,29.4,17,19,0,0,0,0,0,0
2022-12-02T08:00,29.3,21,20,0,10,0,0,0,0
2022-12-02T09:00,29.3,26,22,0,21,0,0,0,0
2022-12-02T10:00,29.4,38,12,28,33,0,0,0,0
2022-12-02T11:00,29.6,42,10,46,18,0,0,0,0
2022-12-02T12:00,29.5,41,4,42,39,0,0,0,0
2022-12-02T13:00,30.1,20,1,30,4,18,9,9,0
2022-12-02T14:00,32.3,32,0,41,25,134,91,43,363.3
2022-12-02T15:00,35.2,54,0,83,13,263,200,63,613.1
2022-12-02T16:00,38.2,55,0,71,40,353,265,88,691.6
2022-12-02T17:00,40.5,33,0,40,30,390,292,98,698.5
2022-12-02T18:00,41.9,41,0,63,9,345,227,118,622.7
2022-12-02T19:00,41.2,53,0,89,0,217,132,85,452.2
2022-12-02T20:00,40.6,55,0,90,4,94,38,56,245.6
2022-12-02T21:00,39.4,48,0,47,66,28,0,28,58.7
2022-12-02T22:00,37.8,55,0,47,90,4,1,3,0
2022-12-02T23:00,36.7,52,0,44,86,0,0,0,0
2022-12-03T00:00,36.5,37,0,57,8,0,0,0,0
2022-12-03T01:00,36.5,79,0,94,76,0,0,0,0
2022-12-03T02:00,36,79,0,82,100,0,0,0,0
2022-12-03T03:00,37.1,37,0,11,100,0,0,0,0
2022-12-03T04:00,37.4,39,0,15,100,0,0,0,0
2022-12-03T05:00,37.8,40,0,17,100,0,0,0,0
2022-12-03T06:00,38.3,77,0,78,99,0,0,0,0
2022-12-03T07:00,39.3,77,0,78,99,0,0,0,0
2022-12-03T08:00,38.9,80,1,84,96,0,0,0,0
2022-12-03T09:00,40.4,100,60,98,100,0,0,0,0
2022-12-03T10:00,40.4,100,97,100,98,0,0,0,0
2022-12-03T11:00,40.6,100,92,100,100,0,0,0,0
2022-12-03T12:00,40.1,100,96,100,100,0,0,0,0
2022-12-03T13:00,42.3,100,88,94,74,2,0,2,0
2022-12-03T14:00,43.7,100,96,100,10,10,0,10,0
2022-12-03T15:00,45.1,100,100,97,0,30,0,30,0
2022-12-03T16:00,47,100,96,58,1,104,37,67,49.7
2022-12-03T17:00,48.6,81,51,54,8,99,23,76,77.2
2022-12-03T18:00,49.5,100,84,77,0,145,55,90,92
2022-12-03T19:00,48.1,100,83,65,0,109,34,75,113
2022-12-03T20:00,44.2,83,89,5,0,91,41,50,120.4
2022-12-03T21:00,42.3,86,93,3,0,48,11,37,114.8
2022-12-03T22:00,40.8,85,68,40,0,6,1,5,14.1
2022-12-03T23:00,39.5,84,70,35,0,0,0,0,0
2022-12-04T00:00,38.1,84,69,37,0,0,0,0,0
2022-12-04T01:00,38.2,91,93,12,0,0,0,0,0
2022-12-04T02:00,37.2,91,90,17,0,0,0,0,0
2022-12-04T03:00,36.8,89,85,20,0,0,0,0,0
2022-12-04T04:00,36,96,91,24,0,0,0,0,0
2022-12-04T05:00,35.7,85,85,14,0,0,0,0,0
2022-12-04T06:00,35.3,80,82,10,0,0,0,0,0
2022-12-04T07:00,35.3,100,86,37,48,0,0,0,0
2022-12-04T08:00,34.7,73,77,5,4,0,0,0,0
2022-12-04T09:00,34.2,70,75,4,0,0,0,0,0
2022-12-04T10:00,33.7,77,80,8,0,0,0,0,0
2022-12-04T11:00,33.4,58,58,9,0,0,0,0,0
2022-12-04T12:00,33.1,26,28,1,0,0,0,0,0
2022-12-04T13:00,33,18,19,1,0,12,5,7,0
2022-12-04T14:00,33.8,38,40,0,8,111,65,46,249.6
2022-12-04T15:00,35.1,100,94,0,85,241,165,76,490.3
2022-12-04T16:00,36.4,100,94,11,79,317,195,122,556.4
2022-12-04T17:00,37.7,100,79,81,88,339,161,178,453.9
2022-12-04T18:00,38.7,100,82,96,95,304,118,186,334.6
2022-12-04T19:00,39.9,83,13,100,38,202,50,152,205.5
2022-12-04T20:00,39.9,10,0,17,0,172,45,127,130.5
2022-12-04T21:00,38.6,2,2,0,0,112,68,44,317.1
2022-12-04T22:00,36.3,2,2,0,0,10,5,5,92.4
2022-12-04T23:00,35.3,2,2,0,0,0,0,0,0
2022-12-05T00:00,34.8,1,1,0,0,0,0,0,0
2022-12-05T01:00,33.5,6,0,0,21,0,0,0,0
2022-12-05T02:00,33.1,11,0,0,37,0,0,0,0
2022-12-05T03:00,32.7,10,0,0,32,0,0,0,0
2022-12-05T04:00,32.4,5,0,0,16,0,0,0,0
2022-12-05T05:00,32.1,3,0,0,11,0,0,0,0
2022-12-05T06:00,31.8,3,0,0,9,0,0,0,0
2022-12-05T07:00,31.4,0,0,0,0,0,0,0,0
2022-12-05T08:00,31.2,0,0,0,0,0,0,0,0
2022-12-05T09:00,31,0,0,0,0,0,0,0,0
2022-12-05T10:00,30.9,0,0,0,0,0,0,0,0
2022-12-05T11:00,30.9,0,0,0,0,0,0,0,0
2022-12-05T12:00,30.8,0,0,0,0,0,0,0,0
2022-12-05T13:00,31.3,6,0,0,21,15,8,7,0
2022-12-05T14:00,33.8,23,0,0,75,132,93,39,380.6
2022-12-05T15:00,37.2,30,0,0,99,270,212,58,670.1
2022-12-05T16:00,40.3,30,0,0,99,343,232,111,693.2
2022-12-05T17:00,42.4,32,0,4,100,357,196,161,542.6
2022-12-05T18:00,44,31,0,2,100,343,180,163,450.5
2022-12-05T19:00,43.8,31,0,2,100,275,117,158,377.8
2022-12-05T20:00,43.2,33,0,7,96,197,77,120,301.5
2022-12-05T21:00,41,28,0,0,94,84,18,66,201.6
2022-12-05T22:00,38.4,41,0,53,32,9,2,7,22.6
2022-12-05T23:00,36.9,42,0,58,24,0,0,0,0
2022-12-06T00:00,36.1,51,0,55,60,0,0,0,0
2022-12-06T01:00,35.4,67,0,66,90,0,0,0,0
2022-12-06T02:00,35.2,83,0,89,100,0,0,0,0
2022-12-06T03:00,35.3,81,0,86,99,0,0,0,0
2022-12-06T04:00,35.8,82,0,87,98,0,0,0,0
2022-12-06T05:00,35.9,80,0,84,99,0,0,0,0
2022-12-06T06:00,35.8,79,0,83,97,0,0,0,0
2022-12-06T07:00,36.8,76,0,77,100,0,0,0,0
2022-12-06T08:00,36.7,76,0,77,100,0,0,0,0
2022-12-06T09:00,36.9,48,0,31,98,0,0,0,0
2022-12-06T10:00,37,67,4,57,98,0,0,0,0
2022-12-06T11:00,37.4,78,1,78,100,0,0,0,0
2022-12-06T12:00,38,84,3,85,100,0,0,0,0
2022-12-06T13:00,37.2,100,33,96,99,5,0,5,0
2022-12-06T14:00,38.5,100,100,100,97,29,1,28,1.9
2022-12-06T15:00,40.2,100,100,100,95,44,6,38,14.5
2022-12-06T16:00,41.5,100,100,100,97,40,2,38,14.2
2022-12-06T17:00,42.6,100,100,100,88,31,0,31,2
2022-12-06T18:00,43.6,100,100,99,94,39,0,39,0
2022-12-06T19:00,44.2,100,100,100,89,28,1,27,1.6
2022-12-06T20:00,44.7,100,100,100,76,25,0,25,1.5
2022-12-06T21:00,45,100,100,100,77,12,0,12,0
2022-12-06T22:00,45,100,100,98,73,1,0,1,0
2022-12-06T23:00,45.1,100,100,93,76,0,0,0,0
2022-12-07T00:00,45.3,100,100,100,90,0,0,0,0
2022-12-07T01:00,45.5,100,100,100,87,0,0,0,0
2022-12-07T02:00,45.9,100,100,100,78,0,0,0,0
2022-12-07T03:00,46.2,100,100,98,84,0,0,0,0
2022-12-07T04:00,46.5,100,100,100,41,0,0,0,0
2022-12-07T05:00,46.6,100,100,100,11,0,0,0,0
2022-12-07T06:00,46.6,100,100,100,59,0,0,0,0
2022-12-07T07:00,46.9,100,100,97,89,0,0,0,0
2022-12-07T08:00,46.8,100,100,76,78,0,0,0,0
2022-12-07T09:00,46.8,100,100,64,33,0,0,0,0
2022-12-07T10:00,46.8,100,100,71,73,0,0,0,0
2022-12-07T11:00,46.8,100,99,55,95,0,0,0,0
2022-12-07T12:00,47,100,100,62,92,0,0,0,0
2022-12-07T13:00,47.2,100,100,81,85,2,0,2,0
2022-12-07T14:00,47.7,100,99,82,81,16,0,16,0
2022-12-07T15:00,48.6,100,100,72,66,34,1,33,1.7
2022-12-07T16:00,49.1,100,100,80,26,38,0,38,1.8
2022-12-07T17:00,49.2,100,100,98,12,24,0,24,0
2022-12-07T18:00,49.4,100,100,96,4,24,0,24,0
2022-12-07T19:00,49.8,100,100,87,17,22,0,22,0
2022-12-07T20:00,49.9,100,100,84,4,25,0,25,0
2022-12-07T21:00,48.9,100,100,77,0,8,0,8,0
2022-12-07T22:00,47.6,100,100,98,0,0,0,0,0
2022-12-07T23:00,45.7,100,100,90,0,0,0,0,0
2022-12-08T00:00,45,100,100,82,0,0,0,0,0
2022-12-08T01:00,45.1,100,100,57,0,0,0,0,0
2022-12-08T02:00,44.8,100,100,32,0,0,0,0,0
2022-12-08T03:00,44.2,99,100,15,0,0,0,0,0
2022-12-08T04:00,43.6,95,100,9,0,0,0,0,0
2022-12-08T05:00,43.1,91,100,1,0,0,0,0,0
2022-12-08T06:00,42.7,91,100,1,0,0,0,0,0
2022-12-08T07:00,43.4,91,100,1,0,0,0,0,0
2022-12-08T08:00,43.2,92,99,4,0,0,0,0,0
2022-12-08T09:00,42.7,97,100,12,0,0,0,0,0
2022-12-08T10:00,42.3,89,93,9,0,0,0,0,0
2022-12-08T11:00,41.7,77,80,8,0,0,0,0,0
2022-12-08T12:00,41.2,53,55,5,0,0,0,0,0
2022-12-08T13:00,40.6,30,33,1,0,5,1,4,0
2022-12-08T14:00,40.6,44,45,5,2,47,13,34,52.2
2022-12-08T15:00,41.3,63,52,17,20,112,51,61,133.8
2022-12-08T16:00,41.2,74,71,10,13,152,67,85,179.8
2022-12-08T17:00,42.4,75,81,3,0,224,140,84,264.3
2022-12-08T18:00,43,79,86,3,0,208,95,113,296
2022-12-08T19:00,43.4,71,66,18,2,151,61,90,192.9
2022-12-08T20:00,43.1,82,75,20,9,147,66,81,203.3
2022-12-08T21:00,41.8,83,82,8,14,67,30,37,232.1
2022-12-08T22:00,40.6,84,93,1,0,5,1,4,37.3
2022-12-08T23:00,39.6,84,90,5,0,0,0,0,0
2022-12-09T00:00,38.9,79,85,4,0,0,0,0,0
2022-12-09T01:00,37.7,88,96,3,0,0,0,0,0
2022-12-09T02:00,37.1,79,88,0,0,0,0,0,0
2022-12-09T03:00,36.9,75,83,0,0,0,0,0,0
2022-12-09T04:00,36.5,80,89,0,0,0,0,0,0
2022-12-09T05:00,36.1,74,82,0,0,0,0,0,0
2022-12-09T06:00,35.8,77,86,0,0,0,0,0,0
2022-12-09T07:00,35.5,72,80,0,0,0,0,0,0
2022-12-09T08:00,35,61,68,0,0,0,0,0,0
2022-12-09T09:00,34,57,63,0,0,0,0,0,0
2022-12-09T10:00,33.7,41,45,0,0,0,0,0,0
2022-12-09T11:00,32.8,38,42,0,0,0,0,0,0
2022-12-09T12:00,32.4,41,46,0,0,0,0,0,0
2022-12-09T13:00,32,59,65,0,0,8,3,5,0
2022-12-09T14:00,32.9,76,84,0,0,101,60,41,236.7
2022-12-09T15:00,34.6,90,100,0,0,198,125,73,429.5
2022-12-09T16:00,36.2,90,100,0,0,289,180,109,475.5
2022-12-09T17:00,37.4,90,100,0,0,316,179,137,463.6
2022-12-09T18:00,38.3,90,100,0,0,341,210,131,492.1
2022-12-09T19:00,36.7,90,100,0,0,179,13,166,278.2
2022-12-09T20:00,36.3,86,96,0,0,135,34,101,58.3
2022-12-09T21:00,35.3,74,82,0,0,75,24,51,150.6
2022-12-09T22:00,33.8,59,65,0,0,7,2,5,31.7
2022-12-09T23:00,32.7,32,36,0,0,0,0,0,0
2022-12-10T00:00,31.9,33,37,0,0,0,0,0,0
2022-12-10T01:00,31.1,8,9,0,0,0,0,0,0
2022-12-10T02:00,30.6,2,2,0,0,0,0,0,0
2022-12-10T03:00,30.1,0,0,0,0,0,0,0,0
2022-12-10T04:00,29.6,0,0,0,0,0,0,0,0
2022-12-10T05:00,29,0,0,0,0,0,0,0,0
2022-12-10T06:00,28.8,0,0,0,0,0,0,0,0
2022-12-10T07:00,28.4,2,0,0,5,0,0,0,0
2022-12-10T08:00,28.3,14,0,0,47,0,0,0,0
2022-12-10T09:00,28,0,0,0,0,0,0,0,0
2022-12-10T10:00,27.6,0,0,0,0,0,0,0,0
2022-12-10T11:00,27.3,1,1,0,0,0,0,0,0
2022-12-10T12:00,27.1,1,1,0,0,0,0,0,0
2022-12-10T13:00,27.2,1,1,0,0,10,5,5,0
2022-12-10T14:00,30.8,1,1,0,0,119,82,37,340.8
2022-12-10T15:00,33.8,0,0,0,0,255,200,55,643.5
2022-12-10T16:00,36.9,1,1,0,0,360,295,65,773.8
2022-12-10T17:00,39.4,0,0,0,0,415,347,68,834
2022-12-10T18:00,41,0,0,0,0,415,347,68,853.9
2022-12-10T19:00,41,0,0,0,0,358,294,64,837.1
2022-12-10T20:00,40.5,30,0,0,99,254,199,55,781.1
2022-12-10T21:00,38.7,29,0,0,96,116,77,39,642.9
2022-12-10T22:00,35.6,30,0,0,99,9,2,7,94.3
2022-12-10T23:00,33.8,29,0,0,95,0,0,0,0
2022-12-11T00:00,32.9,30,0,0,100,0,0,0,0
2022-12-11T01:00,32.7,29,0,0,95,0,0,0,0
2022-12-11T02:00,31.9,29,0,0,96,0,0,0,0
2022-12-11T03:00,31.5,37,3,8,97,0,0,0,0
2022-12-11T04:00,31.2,58,9,34,99,0,0,0,0
2022-12-11T05:00,31.7,80,7,75,96,0,0,0,0
2022-12-11T06:00,32.1,93,9,96,91,0,0,0,0
2022-12-11T07:00,32.1,75,6,94,45,0,0,0,0
2022-12-11T08:00,32.1,80,21,100,3,0,0,0,0
2022-12-11T09:00,32.3,100,70,95,0,0,0,0,0
2022-12-11T10:00,32.3,100,90,88,0,0,0,0,0
2022-12-11T11:00,32.5,100,83,87,3,0,0,0,0
2022-12-11T12:00,32.7,100,84,98,7,0,0,0,0
2022-12-11T13:00,33.1,100,67,97,58,3,0,3,0
2022-12-11T14:00,33.9,100,100,100,34,27,1,26,2.8
2022-12-11T15:00,34.3,100,100,100,12,34,1,33,6.1
2022-12-11T16:00,34.9,100,99,97,0,42,0,42,1
2022-12-11T17:00,35.5,100,88,94,0,76,11,65,12.5
2022-12-11T18:00,36,100,68,75,0,111,17,94,29.9
2022-12-11T19:00,37,100,93,93,6,147,63,84,109.9
2022-12-11T20:00,36.8,100,83,92,41,94,34,60,155.9
2022-12-11T21:00,36,100,86,85,61,52,19,33,130.3
2022-12-11T22:00,35,100,90,90,41,3,0,3,23.2
2022-12-11T23:00,34.6,100,99,100,11,0,0,0,0
2022-12-12T00:00,34.4,100,99,100,0,0,0,0,0
2022-12-12T01:00,34.3,100,96,94,0,0,0,0,0
2022-12-12T02:00,34.5,100,98,89,0,0,0,0,0
2022-12-12T03:00,33.9,100,100,91,0,0,0,0,0
2022-12-12T04:00,33.3,100,100,89,0,0,0,0,0
2022-12-12T05:00,33.3,100,100,85,0,0,0,0,0
2022-12-12T06:00,33.2,100,100,74,0,0,0,0,0
2022-12-12T07:00,32.9,100,100,49,0,0,0,0,0
2022-12-12T08:00,32.9,100,100,59,0,0,0,0,0
2022-12-12T09:00,32.5,100,100,64,0,0,0,0,0
2022-12-12T10:00,32.1,100,100,81,0,0,0,0,0
2022-12-12T11:00,31.5,100,100,76,0,0,0,0,0
2022-12-12T12:00,31,100,100,59,0,0,0,0,0
2022-12-12T13:00,30.6,100,100,29,0,3,0,3,0
2022-12-12T14:00,30.5,98,100,14,0,47,7,40,25.2
2022-12-12T15:00,30.2,94,100,7,0,79,0,79,25.2
2022-12-12T16:00,30.5,94,100,7,0,138,5,133,5.2
2022-12-12T17:00,30.7,91,100,1,0,179,4,175,11.5
2022-12-12T18:00,31.1,90,100,0,0,188,15,173,21.3
2022-12-12T19:00,30.9,90,100,0,0,156,28,128,57.9
2022-12-12T20:00,30.4,88,98,0,0,128,23,105,80.5
2022-12-12T21:00,29.4,83,92,0,0,63,21,42,116.2
2022-12-12T22:00,28.3,82,91,0,0,7,2,5,28.3
2022-12-12T23:00,27.2,82,91,0,0,0,0,0,0
2022-12-13T00:00,26.7,82,91,0,0,0,0,0,0
2022-12-13T01:00,25.5,83,92,0,0,0,0,0,0
2022-12-13T02:00,25.3,86,96,0,0,0,0,0,0
2022-12-13T03:00,25.1,90,100,0,0,0,0,0,0
2022-12-13T04:00,24.7,88,98,0,0,0,0,0,0
2022-12-13T05:00,24.5,87,97,0,0,0,0,0,0
2022-12-13T06:00,24.3,86,96,0,0,0,0,0,0
2022-12-13T07:00,24.3,87,97,0,0,0,0,0,0
2022-12-13T08:00,24,86,95,0,0,0,0,0,0
2022-12-13T09:00,23.6,82,91,0,0,0,0,0,0
2022-12-13T10:00,23.6,50,56,0,0,0,0,0,0
2022-12-13T11:00,23.8,41,46,0,0,0,0,0,0
2022-12-13T12:00,23.9,45,50,0,0,0,0,0,0
2022-12-13T13:00,24.3,54,60,0,0,8,4,4,0
2022-12-13T14:00,25.5,66,73,0,0,104,60,44,266.9
2022-12-13T15:00,27.9,86,96,0,0,239,170,69,529
2022-12-13T16:00,29.8,81,90,0,0,333,238,95,651.2
2022-12-13T17:00,31.6,72,80,0,0,404,310,94,713.2
2022-12-13T18:00,32.8,40,44,0,0,412,337,75,806.5
2022-12-13T19:00,32.7,14,15,0,0,350,274,76,802.7
2022-12-13T20:00,32.4,0,0,0,0,255,197,58,748.7
2022-12-13T21:00,30.6,0,0,0,0,120,83,37,659.2
2022-12-13T22:00,29.1,0,0,0,0,10,5,5,106.9
2022-12-13T23:00,28.2,0,0,0,0,0,0,0,0
2022-12-14T00:00,27.6,0,0,0,0,0,0,0,0
2022-12-14T01:00,27.1,1,1,0,0,0,0,0,0
2022-12-14T02:00,26.5,2,2,0,0,0,0,0,0
2022-12-14T03:00,26.1,7,8,0,0,0,0,0,0
2022-12-14T04:00,25.7,13,14,0,0,0,0,0,0
2022-12-14T05:00,25.7,42,47,0,0,0,0,0,0
2022-12-14T06:00,26.6,85,94,0,0,0,0,0,0
2022-12-14T07:00,27.5,83,92,0,0,0,0,0,0
2022-12-14T08:00,27.1,87,97,0,0,0,0,0,0
2022-12-14T09:00,26.2,86,95,0,0,0,0,0,0
2022-12-14T10:00,25.2,48,53,0,0,0,0,0,0
2022-12-14T11:00,24.5,54,60,0,1,0,0,0,0
2022-12-14T12:00,23.6,63,51,0,58,0,0,0,0
2022-12-14T13:00,23.3,62,68,0,2,6,2,4,0
2022-12-14T14:00,24.2,89,82,0,52,92,50,42,203.9
2022-12-14T15:00,25.8,80,88,0,3,206,127,79,414.5
2022-12-14T16:00,28.2,68,75,0,0,319,228,91,563.2
2022-12-14T17:00,29.6,58,64,0,2,337,225,112,603.4
2022-12-14T18:00,31.2,77,85,0,0,368,251,117,591.5
2022-12-14T19:00,32,80,76,0,39,301,176,125,563.4
2022-12-14T20:00,31.3,80,61,0,83,206,110,96,448.7
2022-12-14T21:00,29.7,49,25,0,87,95,41,54,348.3
2022-12-14T22:00,27.9,73,49,0,95,8,1,7,51.2
2022-12-14T23:00,26.7,71,51,0,82,0,0,0,0
2022-12-15T00:00,26.1,64,43,0,84,0,0,0,0
2022-12-15T01:00,26,58,31,0,99,0,0,0,0
2022-12-15T02:00,25.8,49,21,0,100,0,0,0,0
2022-12-15T03:00,25.6,38,9,0,100,0,0,0,0
2022-12-15T04:00,25.6,30,2,0,94,0,0,0,0
2022-12-15T05:00,25.8,28,2,0,86,0,0,0,0
2022-12-15T06:00,26.1,31,1,0,99,0,0,0,0
2022-12-15T07:00,25.3,29,0,0,95,0,0,0,0
2022-12-15T08:00,25.7,31,1,0,99,0,0,0,0
2022-12-15T09:00,26.2,31,1,0,100,0,0,0,0
2022-12-15T10:00,26.8,31,1,0,100,0,0,0,0
2022-12-15T11:00,28.2,32,1,2,100,0,0,0,0
2022-12-15T12:00,29.6,31,0,1,100,0,0,0,0
2022-12-15T13:00,30.7,64,0,56,100,4,0,4,0
2022-12-15T14:00,32.4,89,0,99,100,47,1,46,3
2022-12-15T15:00,33.4,76,0,77,100,72,0,72,3.8
2022-12-15T16:00,33.8,84,0,91,97,67,0,67,0
2022-12-15T17:00,34,82,0,94,85,81,3,78,3.9
2022-12-15T18:00,33.8,87,0,96,98,50,0,50,4
2022-12-15T19:00,33.3,97,8,100,100,39,0,39,0
2022-12-15T20:00,33.3,100,50,100,100,26,0,26,0
2022-12-15T21:00,33.7,100,71,87,32,9,0,9,0
2022-12-15T22:00,34.1,100,75,100,1,2,0,2,0
2022-12-15T23:00,34.3,100,74,98,9,0,0,0,0
2022-12-16T00:00,35.6,100,62,100,2,0,0,0,0
2022-12-16T01:00,36,100,50,99,1,0,0,0,0
2022-12-16T02:00,36.5,100,64,100,0,0,0,0,0
2022-12-16T03:00,36.9,100,61,100,0,0,0,0,0
2022-12-16T04:00,37,100,89,100,0,0,0,0,0
2022-12-16T05:00,37.1,100,83,100,0,0,0,0,0
2022-12-16T06:00,37.1,100,75,100,0,0,0,0,0
2022-12-16T07:00,36.7,100,79,100,0,0,0,0,0
2022-12-16T08:00,36,100,75,100,0,0,0,0,0
2022-12-16T09:00,36,100,86,98,0,0,0,0,0
2022-12-16T10:00,35.8,100,94,92,14,0,0,0,0
2022-12-16T11:00,35.5,100,99,99,12,0,0,0,0
2022-12-16T12:00,35.2,100,99,97,18,0,0,0,0
2022-12-16T13:00,35.2,100,99,100,13,1,0,1,0
2022-12-16T14:00,35.5,100,91,100,21,17,1,16,2.8
2022-12-16T15:00,35.9,100,86,100,4,43,2,41,7.6
2022-12-16T16:00,36,100,96,100,15,42,0,42,3.7
2022-12-16T17:00,36.3,100,97,99,9,58,0,58,0
2022-12-16T18:00,36.7,100,100,100,3,82,8,74,10.7
2022-12-16T19:00,37.3,100,100,100,1,88,0,88,11
2022-12-16T20:00,36.5,100,100,100,0,53,0,53,0
2022-12-16T21:00,35.9,100,100,100,0,21,0,21,0
2022-12-16T22:00,35.6,100,100,99,0,1,0,1,0
2022-12-16T23:00,35.5,100,97,98,15,0,0,0,0
2022-12-17T00:00,35.3,100,86,95,70,0,0,0,0
2022-12-17T01:00,36.2,100,64,99,81,0,0,0,0
2022-12-17T02:00,36.2,100,47,98,78,0,0,0,0
2022-12-17T03:00,36,100,33,97,63,0,0,0,0
2022-12-17T04:00,35.9,96,33,94,34,0,0,0,0
2022-12-17T05:00,35.5,95,42,92,5,0,0,0,0
2022-12-17T06:00,34.9,71,22,85,0,0,0,0,0
2022-12-17T07:00,34.7,50,15,61,0,0,0,0,0
2022-12-17T08:00,34.2,14,4,18,0,0,0,0,0
2022-12-17T09:00,33.3,13,7,11,0,0,0,0,0
2022-12-17T10:00,32.4,24,9,26,0,0,0,0,0
2022-12-17T11:00,31.7,37,17,36,0,0,0,0,0
2022-12-17T12:00,31,32,28,12,0,0,0,0,0
2022-12-17T13:00,30.6,42,45,3,0,5,2,3,0
2022-12-17T14:00,31.4,49,46,5,15,85,42,43,185.5
2022-12-17T15:00,33.3,53,44,22,1,203,120,83,385.4
2022-12-17T16:00,34.6,86,74,33,0,297,181,116,491.6
2022-12-17T17:00,35.9,97,80,41,0,314,186,128,489.6
2022-12-17T18:00,36.7,78,68,28,0,327,203,124,491.3
2022-12-17T19:00,36.6,85,60,51,0,233,104,129,401.6
2022-12-17T20:00,36.3,92,62,60,0,163,75,88,279.4
2022-12-17T21:00,35.5,91,57,66,0,74,23,51,220.3
2022-12-17T22:00,34.8,68,21,82,0,8,1,7,29.7
2022-12-17T23:00,34.3,63,29,62,0,0,0,0,0
2022-12-18T00:00,33.5,21,9,14,16,0,0,0,0
2022-12-18T01:00,32.7,46,17,45,11,0,0,0,0
2022-12-18T02:00,31.5,48,9,58,18,0,0,0,0
2022-12-18T03:00,30.2,38,12,17,57,0,0,0,0
2022-12-18T04:00,28.7,35,5,25,52,0,0,0,0
2022-12-18T05:00,27,29,4,18,47,0,0,0,0
2022-12-18T06:00,25.7,31,1,46,7,0,0,0,0
2022-12-18T07:00,26.1,54,9,77,0,0,0,0,0
2022-12-18T08:00,25.7,55,2,89,0,0,0,0,0
2022-12-18T09:00,25.1,65,6,97,3,0,0,0,0
2022-12-18T10:00,25.1,77,22,96,0,0,0,0,0
2022-12-18T11:00,25.2,78,20,95,10,0,0,0,0
2022-12-18T12:00,25.1,86,41,79,7,0,0,0,0
2022-12-18T13:00,25.4,65,43,44,1,4,1,3,0
2022-12-18T14:00,27.1,64,66,8,0,87,35,52,141.3
2022-12-18T15:00,29.5,80,88,2,0,191,106,85,331.5
2022-12-18T16:00,32.1,78,83,5,0,307,196,111,486.6
2022-12-18T17:00,33.8,91,99,3,0,332,207,125,553.2
2022-12-18T18:00,34.2,91,83,27,0,263,116,147,412
2022-12-18T19:00,34.8,68,42,50,0,184,30,154,164.8
2022-12-18T20:00,34.3,49,28,40,0,205,113,92,238.8
2022-12-18T21:00,33.2,59,37,43,0,108,59,49,430.5
2022-12-18T22:00,31.3,40,6,58,0,10,3,7,81.1
2022-12-18T23:00,30.6,52,20,56,0,0,0,0,0
2022-12-19T00:00,29.9,44,11,56,0,0,0,0,0
2022-12-19T01:00,29.2,59,31,51,0,0,0,0,0
2022-12-19T02:00,30,84,65,43,0,0,0,0,0
2022-12-19T03:00,31,83,57,53,0,0,0,0,0
2022-12-19T04:00,31.5,59,50,24,0,0,0,0,0
2022-12-19T05:00,31.7,77,80,9,0,0,0,0,0
2022-12-19T06:00,31.5,82,87,7,0,0,0,0,0
2022-12-19T07:00,31,53,55,6,0,0,0,0,0
2022-12-19T08:00,30.7,41,41,7,0,0,0,0,0
2022-12-19T09:00,30.3,49,43,17,0,0,0,0,0
2022-12-19T10:00,29.9,33,37,0,0,0,0,0,0
2022-12-19T11:00,29.7,32,33,4,0,0,0,0,0
2022-12-19T12:00,29.3,36,32,12,0,0,0,0,0
2022-12-19T13:00,29.3,86,68,42,0,4,1,3,0
2022-12-19T14:00,30.1,100,70,71,0,65,18,47,84.5
2022-12-19T15:00,31.4,100,80,80,0,159,55,104,176.1
2022-12-19T16:00,32.4,100,90,86,0,218,65,153,202.8
2022-12-19T17:00,33.4,100,76,77,0,249,57,192,164.9
2022-12-19T18:00,33.7,100,98,59,0,195,41,154,121.4
2022-12-19T19:00,34.1,100,94,54,0,186,32,154,88.2
2022-12-19T20:00,33.8,100,84,55,0,173,63,110,161.3
2022-12-19T21:00,32.9,100,92,68,0,86,24,62,205.5
2022-12-19T22:00,31.2,90,54,69,0,9,2,7,33.8
2022-12-19T23:00,30.5,92,51,77,0,0,0,0,0
2022-12-20T00:00,30.3,100,94,78,0,0,0,0,0
2022-12-20T01:00,29.9,100,99,81,0,0,0,0,0
2022-12-20T02:00,29.8,96,81,39,0,0,0,0,0
2022-12-20T03:00,29.9,78,83,6,0,0,0,0,0
2022-12-20T04:00,29.9,77,82,5,0,0,0,0,0
2022-12-20T05:00,29.6,52,55,4,0,0,0,0,0
2022-12-20T06:00,28.8,53,59,0,0,0,0,0,0
2022-12-20T07:00,29.6,50,56,0,0,0,0,0,0
2022-12-20T08:00,29,51,57,0,0,0,0,0,0
2022-12-20T09:00,28.7,53,59,0,0,0,0,0,0
2022-12-20T10:00,28.3,69,77,0,0,0,0,0,0
2022-12-20T11:00,27.9,65,72,0,0,0,0,0,0
2022-12-20T12:00,27.6,68,76,0,0,0,0,0,0
2022-12-20T13:00,27.2,70,78,0,0,4,1,3,0
2022-12-20T14:00,28.1,68,76,0,0,78,37,41,158.8
2022-12-20T15:00,29.5,72,75,7,0,175,75,100,295.2
2022-12-20T16:00,30.4,100,100,50,0,227,77,150,260.5
2022-12-20T17:00,30.8,100,100,48,0,216,37,179,155.6
2022-12-20T18:00,31.1,91,100,2,0,183,25,158,75
2022-12-20T19:00,31.5,90,100,0,0,153,0,153,30.3
2022-12-20T20:00,31.3,91,100,1,0,94,0,94,0
2022-12-20T21:00,31,100,100,17,0,56,6,50,20.2
2022-12-20T22:00,30.4,100,94,28,0,6,1,5,9.8
2022-12-20T23:00,30.1,74,79,4,0,0,0,0,0
2022-12-21T00:00,29.8,49,54,0,0,0,0,0,0
2022-12-21T01:00,29.1,29,32,0,0,0,0,0,0
2022-12-21T02:00,28.3,12,13,0,0,0,0,0,0
2022-12-21T03:00,27.2,11,12,0,0,0,0,0,0
2022-12-21T04:00,26,7,8,0,0,0,0,0,0
2022-12-21T05:00,24.8,2,2,0,0,0,0,0,0
2022-12-21T06:00,23.6,6,2,0,15,0,0,0,0
2022-12-21T07:00,22.4,57,44,0,59,0,0,0,0
2022-12-21T08:00,21.4,100,88,30,88,0,0,0,0
2022-12-21T09:00,20.3,100,89,37,92,0,0,0,0
2022-12-21T10:00,20.3,100,71,24,95,0,0,0,0
2022-12-21T11:00,20.4,75,51,9,79,0,0,0,0
2022-12-21T12:00,20.1,93,57,38,64,0,0,0,0
2022-12-21T13:00,19.8,90,66,37,28,5,1,4,0
2022-12-21T14:00,22.2,35,38,2,0,96,57,39,224.5
2022-12-21T15:00,26.9,4,4,0,0,236,178,58,569.3
2022-12-21T16:00,31.2,10,11,0,0,344,274,70,744.1
2022-12-21T17:00,34,5,5,0,0,405,327,78,805.1
2022-12-21T18:00,35.8,0,0,0,0,415,340,75,839.5
2022-12-21T19:00,37,2,2,0,0,350,266,84,798.8
2022-12-21T20:00,37.1,14,2,0,39,249,181,68,706.2
2022-12-21T21:00,36.2,31,1,0,100,111,66,45,558.1
2022-12-21T22:00,34.5,31,2,0,97,12,4,8,94.8
2022-12-21T23:00,32.9,30,0,0,99,0,0,0,0
2022-12-22T00:00,31.6,40,0,17,100,0,0,0,0
2022-12-22T01:00,30.5,79,0,81,100,0,0,0,0
2022-12-22T02:00,29.4,86,0,93,99,0,0,0,0
2022-12-22T03:00,28.6,81,0,85,99,0,0,0,0
2022-12-22T04:00,28.2,86,0,93,100,0,0,0,0
2022-12-22T05:00,28.2,85,0,91,100,0,0,0,0
2022-12-22T06:00,28,85,0,92,100,0,0,0,0
2022-12-22T07:00,29,87,0,95,100,0,0,0,0
2022-12-22T08:00,29.5,82,0,86,100,0,0,0,0
2022-12-22T09:00,29.8,85,0,91,100,0,0,0,0
2022-12-22T10:00,30,89,0,99,100,0,0,0,0
2022-12-22T11:00,30.6,90,0,100,100,0,0,0,0
2022-12-22T12:00,31.2,89,0,98,100,0,0,0,0
2022-12-22T13:00,31.5,85,0,92,99,3,0,3,0
2022-12-22T14:00,32.4,50,0,34,98,48,4,44,9.3
2022-12-22T15:00,33.9,54,0,49,81,155,40,115,78.5
2022-12-22T16:00,35.1,83,2,89,92,286,175,111,333.5
2022-12-22T17:00,35.8,78,0,83,93,283,167,116,483.9
2022-12-22T18:00,36.6,86,1,93,96,226,85,141,321.7
2022-12-22T19:00,36.6,100,13,100,96,88,6,82,107.6
2022-12-22T20:00,36.9,92,2,100,99,38,0,38,1.8
2022-12-22T21:00,37,100,14,98,98,20,0,20,0
2022-12-22T22:00,37.1,98,16,90,98,4,1,3,0
2022-12-22T23:00,38.4,100,73,89,96,0,0,0,0
2022-12-23T00:00,39.5,100,100,93,96,0,0,0,0
2022-12-23T01:00,40.4,100,100,98,98,0,0,0,0
2022-12-23T02:00,40.9,100,100,100,94,0,0,0,0
2022-12-23T03:00,41,100,99,81,98,0,0,0,0
2022-12-23T04:00,41.3,100,82,46,100,0,0,0,0
2022-12-23T05:00,42.3,100,80,87,100,0,0,0,0
2022-12-23T06:00,44.1,100,100,99,99,0,0,0,0
2022-12-23T07:00,43.4,100,100,88,94,0,0,0,0
2022-12-23T08:00,44.1,100,100,99,91,0,0,0,0
2022-12-23T09:00,43.8,100,100,96,68,0,0,0,0
2022-12-23T10:00,43.7,100,100,100,31,0,0,0,0
2022-12-23T11:00,43.8,100,99,93,42,0,0,0,0
2022-12-23T12:00,43.4,100,99,67,35,0,0,0,0
2022-12-23T13:00,42.5,100,85,95,85,1,0,1,0
2022-12-23T14:00,42,100,66,98,58,19,1,18,3
2022-12-23T15:00,41.7,100,56,100,86,43,2,41,8
2022-12-23T16:00,36.5,100,82,68,74,38,3,35,6.5
2022-12-23T17:00,29.2,100,81,98,82,80,12,68,19.9
2022-12-23T18:00,25.9,100,86,95,91,106,5,101,21.6
2022-12-23T19:00,22.5,100,99,100,97,120,10,110,19.3
2022-12-23T20:00,18.5,100,95,100,78,79,7,72,28.1
2022-12-23T21:00,14.3,100,97,100,69,36,1,35,16.6
2022-12-23T22:00,11,100,97,100,35,5,0,5,0.4
2022-12-23T23:00,8.8,100,95,100,38,0,0,0,0
2022-12-24T00:00,7.1,100,90,100,29,0,0,0,0
2022-12-24T01:00,6.1,100,94,100,27,0,0,0,0
2022-12-24T02:00,5.5,100,98,100,33,0,0,0,0
2022-12-24T03:00,6.2,100,97,100,51,0,0,0,0
2022-12-24T04:00,6.9,100,97,99,78,0,0,0,0
2022-12-24T05:00,7.1,100,79,88,97,0,0,0,0
2022-12-24T06:00,7,100,70,80,99,0,0,0,0
2022-12-24T07:00,5.2,100,74,83,48,0,0,0,0
2022-12-24T08:00,5.2,100,81,91,55,0,0,0,0
2022-12-24T09:00,4.8,100,77,76,1,0,0,0,0
2022-12-24T10:00,4.1,100,65,80,52,0,0,0,0
2022-12-24T11:00,3.4,100,67,90,81,0,0,0,0
2022-12-24T12:00,3.5,100,41,68,94,0,0,0,0
2022-12-24T13:00,3.6,74,41,62,0,4,0,4,0
2022-12-24T14:00,4.8,62,33,49,9,82,34,48,122.2
2022-12-24T15:00,6.2,79,25,89,9,210,111,99,357.8
2022-12-24T16:00,8,76,20,94,6,288,144,144,428.5
2022-12-24T17:00,9.9,64,10,91,2,337,176,161,438.5
2022-12-24T18:00,11,34,12,38,0,231,60,171,275.4
2022-12-24T19:00,12.4,4,4,0,0,361,258,103,410.4
2022-12-24T20:00,12.7,6,7,0,0,280,223,57,790.7
2022-12-24T21:00,12.4,13,2,18,0,133,90,43,712.8
2022-12-24T22:00,11.5,38,0,46,33,14,6,8,140.1
2022-12-24T23:00,10.9,37,3,31,51,0,0,0,0
2022-12-25T00:00,10.6,32,3,40,17,0,0,0,0
2022-12-25T01:00,10.8,32,4,37,22,0,0,0,0
2022-12-25T02:00,10.8,17,9,5,18,0,0,0,0
2022-12-25T03:00,11.1,14,8,0,21,0,0,0,0
2022-12-25T04:00,11.7,14,4,17,0,0,0,0,0
2022-12-25T05:00,12.6,11,10,2,4,0,0,0,0
2022-12-25T06:00,13.5,15,7,4,21,0,0,0,0
2022-12-25T07:00,11.6,13,2,14,8,0,0,0,0
2022-12-25T08:00,12.5,47,52,0,0,0,0,0,0
2022-12-25T09:00,13.3,63,69,1,0,0,0,0,0
2022-12-25T10:00,14,100,97,31,0,0,0,0,0
2022-12-25T11:00,14.6,100,95,81,0,0,0,0,0
2022-12-25T12:00,15,100,93,98,0,0,0,0,0
2022-12-25T13:00,15.3,100,83,92,0,4,1,3,0
2022-12-25T14:00,16.7,95,77,43,0,91,53,38,220.9
2022-12-25T15:00,18.4,74,71,16,0,222,149,73,505.6
2022-12-25T16:00,20.4,52,47,13,6,334,246,88,647.8
2022-12-25T17:00,21.9,76,55,37,14,397,301,96,738.2
2022-12-25T18:00,23,73,41,56,9,389,279,110,730.2
2022-12-25T19:00,23.4,72,58,31,5,324,215,109,644.4
2022-12-25T20:00,23.1,88,81,16,17,233,139,94,550.8
2022-12-25T21:00,22.3,69,42,16,71,102,48,54,409.6
2022-12-25T22:00,21.2,100,97,30,96,12,2,10,73.6
2022-12-25T23:00,20.7,100,95,68,58,0,0,0,0
2022-12-26T00:00,20.1,100,98,55,0,0,0,0,0
2022-12-26T01:00,19.7,93,92,17,0,0,0,0,0
2022-12-26T02:00,19,61,57,16,0,0,0,0,0
2022-12-26T03:00,18.2,37,31,15,0,0,0,0,0
2022-12-26T04:00,17.7,33,19,27,0,0,0,0,0
2022-12-26T05:00,17.6,53,50,14,0,0,0,0,0
2022-12-26T06:00,17.4,7,6,2,0,0,0,0,0
2022-12-26T07:00,14.4,15,16,1,0,0,0,0,0
2022-12-26T08:00,13.7,10,10,2,0,0,0,0,0
2022-12-26T09:00,13.3,20,22,0,1,0,0,0,0
2022-12-26T10:00,13,23,26,0,0,0,0,0,0
2022-12-26T11:00,12.9,33,37,0,0,0,0,0,0
2022-12-26T12:00,13.1,31,34,0,0,0,0,0,0
2022-12-26T13:00,13.2,34,32,0,17,4,1,3,0
2022-12-26T14:00,15.2,62,39,5,80,94,59,35,247.2
2022-12-26T15:00,18,40,13,1,92,225,156,69,547.4
2022-12-26T16:00,20.5,36,7,0,99,340,256,84,679.5
2022-12-26T17:00,22.4,31,4,38,15,386,278,108,741.9
2022-12-26T18:00,23.4,84,14,74,90,286,87,199,442.1
2022-12-26T19:00,24.4,86,23,60,99,336,224,112,404.7
2022-12-26T20:00,24.6,63,19,26,100,212,90,122,495
2022-12-26T21:00,24,98,42,50,100,95,24,71,231.8
2022-12-26T22:00,22.8,98,41,52,100,9,0,9,35.4
2022-12-26T23:00,22.3,100,58,55,98,0,0,0,0
2022-12-27T00:00,21.3,100,70,70,92,0,0,0,0
2022-12-27T01:00,21.7,100,61,95,87,0,0,0,0
2022-12-27T02:00,21.9,100,58,95,73,0,0,0,0
2022-12-27T03:00,21.4,86,32,92,5,0,0,0,0
2022-12-27T04:00,21.6,68,11,93,9,0,0,0,0
2022-12-27T05:00,21.1,64,8,76,36,0,0,0,0
2022-12-27T06:00,21,49,15,56,6,0,0,0,0
2022-12-27T07:00,20.1,31,10,37,0,0,0,0,0
2022-12-27T08:00,18.9,62,37,48,0,0,0,0,0
2022-12-27T09:00,18.7,100,75,72,0,0,0,0,0
2022-12-27T10:00,18.9,100,91,77,4,0,0,0,0
2022-12-27T11:00,19.3,100,90,61,57,0,0,0,0
2022-12-27T12:00,19.3,100,79,38,95,0,0,0,0
2022-12-27T13:00,18.8,95,83,25,17,3,0,3,0
2022-12-27T14:00,20.4,88,88,15,0,83,46,37,171.9
2022-12-27T15:00,22.6,86,89,10,0,204,127,77,437.8
2022-12-27T16:00,24.8,81,89,2,0,307,222,85,571.3
2022-12-27T17:00,26.8,88,97,2,0,357,257,100,649.2
2022-12-27T18:00,28.1,91,100,1,0,358,231,127,621.4
2022-12-27T19:00,28.7,90,100,0,0,252,89,163,411
2022-12-27T20:00,29,90,100,0,0,163,41,122,184.1
2022-12-27T21:00,28.8,90,100,0,0,77,15,62,117
2022-12-27T22:00,27.6,100,85,0,77,10,2,8,26.2
2022-12-27T23:00,26.3,87,80,0,50,0,0,0,0
2022-12-28T00:00,25.1,75,64,2,54,0,0,0,0
2022-12-28T01:00,23.4,44,48,1,0,0,0,0,0
2022-12-28T02:00,22.5,65,53,1,55,0,0,0,0
2022-12-28T03:00,22,71,46,3,94,0,0,0,0
2022-12-28T04:00,22.2,76,42,14,100,0,0,0,0
2022-12-28T05:00,22.4,100,59,54,99,0,0,0,0
2022-12-28T06:00,23.5,100,65,59,100,0,0,0,0
2022-12-28T07:00,26.1,100,54,45,100,0,0,0,0
2022-12-28T08:00,26.8,100,54,69,100,0,0,0,0
2022-12-28T09:00,27.7,100,59,79,100,0,0,0,0
2022-12-28T10:00,28.6,100,39,85,100,0,0,0,0
2022-12-28T11:00,28.9,100,16,98,100,0,0,0,0
2022-12-28T12:00,29.4,96,8,99,97,0,0,0,0
2022-12-28T13:00,29.3,83,2,91,87,3,0,3,0
2022-12-28T14:00,31,88,5,93,92,61,12,49,42.9
2022-12-28T15:00,33.7,62,0,86,36,153,46,107,138.6
2022-12-28T16:00,36.4,70,0,79,76,233,82,151,199
2022-12-28T17:00,39.1,46,0,63,27,330,205,125,366.7
2022-12-28T18:00,41.2,41,0,38,60,376,278,98,614
2022-12-28T19:00,42.2,31,0,2,99,310,203,107,643.1
2022-12-28T20:00,41.8,37,0,31,62,173,52,121,365.8
2022-12-28T21:00,40.5,30,0,0,99,96,32,64,176.6
2022-12-28T22:00,37.8,30,0,0,100,14,5,9,60.8
2022-12-28T23:00,36.7,30,0,0,100,0,0,0,0
2022-12-29T00:00,36.3,30,0,0,100,0,0,0,0
2022-12-29T01:00,35.8,30,0,0,100,0,0,0,0
2022-12-29T02:00,35.5,29,0,0,98,0,0,0,0
2022-12-29T03:00,35.2,29,0,0,98,0,0,0,0
2022-12-29T04:00,35,28,0,0,92,0,0,0,0
2022-12-29T05:00,34.8,29,0,0,96,0,0,0,0
2022-12-29T06:00,34.6,30,0,0,99,0,0,0,0
2022-12-29T07:00,35,30,0,0,99,0,0,0,0
2022-12-29T08:00,34.8,29,0,0,96,0,0,0,0
2022-12-29T09:00,34.5,27,0,0,90,0,0,0,0
2022-12-29T10:00,34.2,24,0,0,79,0,0,0,0
2022-12-29T11:00,34,19,0,0,64,0,0,0,0
2022-12-29T12:00,33.8,7,0,0,22,0,0,0,0
2022-12-29T13:00,34.2,2,0,0,6,4,1,3,0
2022-12-29T14:00,37.1,1,0,0,3,89,56,33,236.9
2022-12-29T15:00,40.7,1,0,0,4,223,170,53,565.4
2022-12-29T16:00,43.8,0,0,0,0,328,263,65,716.7
2022-12-29T17:00,46,0,0,0,0,387,318,69,776.4
2022-12-29T18:00,47.3,0,0,0,0,395,329,66,802.9
2022-12-29T19:00,48,6,7,0,0,352,292,60,811.5
2022-12-29T20:00,47.7,52,58,0,0,230,159,71,690
2022-12-29T21:00,45.8,79,88,0,0,86,41,45,405.7
2022-12-29T22:00,44.3,79,88,0,0,6,0,6,65
2022-12-29T23:00,44.4,72,80,0,0,0,0,0,0
2022-12-30T00:00,43.5,72,80,0,0,0,0,0,0
2022-12-30T01:00,43.7,89,99,0,0,0,0,0,0
2022-12-30T02:00,44.1,99,100,0,29,0,0,0,0
2022-12-30T03:00,44.3,100,100,3,73,0,0,0,0
2022-12-30T04:00,44.1,100,100,1,79,0,0,0,0
2022-12-30T05:00,44.3,100,100,0,77,0,0,0,0
2022-12-30T06:00,44.3,100,99,12,85,0,0,0,0
2022-12-30T07:00,45.1,100,86,14,90,0,0,0,0
2022-12-30T08:00,44.9,100,89,20,91,0,0,0,0
2022-12-30T09:00,44.7,100,73,49,95,0,0,0,0
2022-12-30T10:00,44.5,71,70,11,5,0,0,0,0
2022-12-30T11:00,44.4,55,55,9,0,0,0,0,0
2022-12-30T12:00,44.4,48,46,11,0,0,0,0,0
2022-12-30T13:00,45,63,51,28,0,1,0,1,0
2022-12-30T14:00,46.4,71,55,35,0,30,12,18,44.6
2022-12-30T15:00,48.6,55,46,23,0,96,35,61,121.6
2022-12-30T16:00,52.9,100,83,62,36,124,34,90,119.3
2022-12-30T17:00,54.9,100,99,89,44,105,39,66,98.5
2022-12-30T18:00,55.4,62,41,42,0,117,10,107,47.6
2022-12-30T19:00,57.9,53,12,29,83,228,133,95,181.3
2022-12-30T20:00,57.6,45,11,17,83,211,141,70,441.1
2022-12-30T21:00,55.7,55,18,18,94,117,73,44,479.6
2022-12-30T22:00,52.2,34,1,5,100,17,8,9,137.8
2022-12-30T23:00,50.4,31,0,1,100,0,0,0,0
2022-12-31T00:00,48.8,30,0,0,100,0,0,0,0
2022-12-31T01:00,48,30,0,0,100,0,0,0,0
2022-12-31T02:00,47.9,32,2,0,100,0,0,0,0
2022-12-31T03:00,47.5,43,10,6,100,0,0,0,0
2022-12-31T04:00,47.2,36,5,3,100,0,0,0,0
2022-12-31T05:00,46,31,1,0,100,0,0,0,0
2022-12-31T06:00,45,31,1,0,100,0,0,0,0
2022-12-31T07:00,45.9,30,0,0,100,0,0,0,0
2022-12-31T08:00,45.8,30,0,0,100,0,0,0,0
2022-12-31T09:00,45.7,35,3,3,100,0,0,0,0
2022-12-31T10:00,45.7,65,14,38,100,0,0,0,0
2022-12-31T11:00,46.1,91,23,67,100,0,0,0,0
2022-12-31T12:00,46.4,100,26,90,100,0,0,0,0
2022-12-31T13:00,46.8,100,45,91,100,2,0,2,0
2022-12-31T14:00,47.7,89,23,64,100,25,0,25,0
2022-12-31T15:00,49.5,100,35,95,98,75,2,73,3.9
2022-12-31T16:00,50.5,100,45,99,100,93,0,93,3.8
2022-12-31T17:00,51.2,100,63,55,98,103,1,102,0.2
2022-12-31T18:00,52.3,100,58,69,99,140,14,126,19.6
2022-12-31T19:00,52.1,100,43,100,100,87,0,87,18.7
2022-12-31T20:00,51.3,100,63,100,100,41,0,41,0
2022-12-31T21:00,51,100,100,100,56,9,0,9,0
2022-12-31T22:00,50.7,100,100,94,92,2,0,2,0
2022-12-31T23:00,50.4,100,100,99,98,0,0,0,0
2023-01-01T00:00,50.4,100,98,100,100,0,0,0,0
2023-01-01T01:00,50.1,100,100,99,100,0,0,0,0
2023-01-01T02:00,50.1,100,100,95,100,0,0,0,0
2023-01-01T03:00,50,100,100,80,100,0,0,0,0
2023-01-01T04:00,49.6,100,100,49,79,0,0,0,0
2023-01-01T05:00,48.6,100,100,16,2,0,0,0,0
2023-01-01T06:00,47.3,91,100,1,0,0,0,0,0
2023-01-01T07:00,45.7,90,100,0,0,0,0,0,0
2023-01-01T08:00,44,90,100,0,0,0,0,0,0
2023-01-01T09:00,42.7,88,98,0,0,0,0,0,0
2023-01-01T10:00,41.5,87,97,0,0,0,0,0,0
2023-01-01T11:00,40.4,85,94,0,0,0,0,0,0
2023-01-01T12:00,39.3,100,84,0,84,0,0,0,0
2023-01-01T13:00,38.3,100,86,1,84,2,0,2,0
2023-01-01T14:00,37.7,85,88,0,19,38,13,25,47.5
2023-01-01T15:00,38.3,60,65,1,2,117,47,70,150.3
2023-01-01T16:00,38.9,83,89,4,0,117,40,77,153.1
2023-01-01T17:00,40.5,100,99,93,61,205,44,161,109
2023-01-01T18:00,42,100,69,100,99,197,42,155,109.3
2023-01-01T19:00,42.9,88,9,100,65,112,5,107,57.6
2023-01-01T20:00,43,59,5,72,37,99,9,90,12.6
2023-01-01T21:00,43.1,37,2,58,0,84,28,56,101
2023-01-01T22:00,41.7,41,2,66,0,12,3,9,57.7
2023-01-01T23:00,41.4,83,32,90,0,0,0,0,0
2023-01-02T00:00,40.8,100,99,99,0,0,0,0,0
2023-01-02T01:00,39.5,100,100,78,1,0,0,0,0
2023-01-02T02:00,40.6,100,100,22,0,0,0,0,0
2023-01-02T03:00,40.7,90,100,0,0,0,0,0,0
2023-01-02T04:00,41.7,95,100,0,17,0,0,0,0
2023-01-02T05:00,42.3,92,100,0,6,0,0,0,0
2023-01-02T06:00,42.3,100,94,0,59,0,0,0,0
2023-01-02T07:00,42.2,100,99,1,87,0,0,0,0
2023-01-02T08:00,41.8,100,94,7,94,0,0,0,0
2023-01-02T09:00,41.3,97,98,12,5,0,0,0,0
2023-01-02T10:00,41,100,85,47,86,0,0,0,0
2023-01-02T11:00,40.6,100,90,80,81,0,0,0,0
2023-01-02T12:00,40.6,100,92,80,0,0,0,0,0
2023-01-02T13:00,40.9,100,95,43,3,1,0,1,0
2023-01-02T14:00,42,100,92,19,35,34,11,23,41.5
2023-01-02T15:00,44,93,88,5,37,91,30,61,100.6
2023-01-02T16:00,45.1,96,97,8,12,164,85,79,175.7
2023-01-02T17:00,46.6,100,99,36,70,253,139,114,299.2
2023-01-02T18:00,47.6,100,100,32,62,238,120,118,324.1
2023-01-02T19:00,49.6,100,96,5,72,200,90,110,263.4
2023-01-02T20:00,49.5,80,69,5,48,168,74,94,245.2
2023-01-02T21:00,48,42,36,1,31,92,41,51,248.3
2023-01-02T22:00,45.6,22,23,0,5,16,7,9,87
2023-01-02T23:00,43.1,34,9,0,87,0,0,0,0
2023-01-03T00:00,40.9,22,3,0,63,0,0,0,0
2023-01-03T01:00,39,13,3,0,35,0,0,0,0
2023-01-03T02:00,37.5,9,10,0,0,0,0,0,0
2023-01-03T03:00,36.1,29,9,0,68,0,0,0,0
2023-01-03T04:00,35.4,35,5,0,100,0,0,0,0
2023-01-03T05:00,35.3,66,40,0,100,0,0,0,0
2023-01-03T06:00,35.6,47,19,0,100,0,0,0,0
2023-01-03T07:00,36.3,62,35,0,100,0,0,0,0
2023-01-03T08:00,37,93,65,8,100,0,0,0,0
2023-01-03T09:00,38.7,100,90,26,100,0,0,0,0
2023-01-03T10:00,40.6,100,100,39,100,0,0,0,0
2023-01-03T11:00,42.3,100,99,51,100,0,0,0,0
2023-01-03T12:00,43.9,100,97,50,100,0,0,0,0
2023-01-03T13:00,45.2,100,88,69,100,0,0,0,0
2023-01-03T14:00,46.8,100,92,93,100,14,0,14,0
2023-01-03T15:00,47,100,81,97,100,36,0,36,0
2023-01-03T16:00,48,100,85,98,100,48,0,48,0
2023-01-03T17:00,48.6,100,79,100,100,42,0,42,0
2023-01-03T18:00,49,100,62,100,100,35,0,35,0
2023-01-03T19:00,49.3,100,68,100,100,43,0,43,0
2023-01-03T20:00,49.5,100,77,100,100,21,0,21,0
2023-01-03T21:00,49.5,100,92,100,100,9,0,9,0
2023-01-03T22:00,49.5,100,97,100,100,2,0,2,0
2023-01-03T23:00,49.6,100,100,98,98,0,0,0,0
2023-01-04T00:00,49.6,100,100,100,58,0,0,0,0
2023-01-04T01:00,49.8,100,100,100,89,0,0,0,0
2023-01-04T02:00,50.3,100,100,99,100,0,0,0,0
2023-01-04T03:00,50.8,100,100,96,100,0,0,0,0
2023-01-04T04:00,51.2,100,100,83,100,0,0,0,0
2023-01-04T05:00,51.5,100,100,35,85,0,0,0,0
2023-01-04T06:00,51.8,100,97,17,73,0,0,0,0
2023-01-04T07:00,51.1,100,99,35,55,0,0,0,0
2023-01-04T08:00,50.5,100,99,60,38,0,0,0,0
2023-01-04T09:00,49.5,100,100,71,79,0,0,0,0
2023-01-04T10:00,48.6,100,100,8,43,0,0,0,0
2023-01-04T11:00,48.1,100,100,15,90,0,0,0,0
2023-01-04T12:00,47.8,100,100,31,94,0,0,0,0
2023-01-04T13:00,47.8,100,100,26,89,0,0,0,0
2023-01-04T14:00,49.1,100,100,68,100,13,0,13,0
2023-01-04T15:00,49.6,100,100,97,100,22,0,22,0
2023-01-04T16:00,51.3,100,100,90,100,36,0,36,0
2023-01-04T17:00,51.8,100,98,21,100,58,4,54,4.8
2023-01-04T18:00,54.7,100,90,61,100,86,4,82,9.6
2023-01-04T19:00,57.5,100,78,98,100,104,6,98,13.6
2023-01-04T20:00,55.8,100,98,99,100,43,0,43,8.1
2023-01-04T21:00,55.1,100,77,100,100,16,0,16,0
2023-01-04T22:00,54.4,100,68,91,100,2,0,2,0
2023-01-04T23:00,53.8,100,24,96,86,0,0,0,0
2023-01-05T00:00,53.7,48,4,70,7,0,0,0,0
2023-01-05T01:00,54.3,65,12,79,23,0,0,0,0
2023-01-05T02:00,55.2,92,32,100,11,0,0,0,0
2023-01-05T03:00,55.9,52,24,51,1,0,0,0,0
2023-01-05T04:00,56.4,47,36,25,0,0,0,0,0
2023-01-05T05:00,56.5,66,50,35,0,0,0,0,0
2023-01-05T06:00,55.6,85,76,28,0,0,0,0,0
2023-01-05T07:00,53.3,90,89,17,0,0,0,0,0
2023-01-05T08:00,51.2,92,100,4,0,0,0,0,0
2023-01-05T09:00,49.5,79,87,0,1,0,0,0,0
2023-01-05T10:00,47.7,47,39,0,38,0,0,0,0
2023-01-05T11:00,46.4,38,14,0,85,0,0,0,0
2023-01-05T12:00,45.2,35,5,3,97,0,0,0,0
2023-01-05T13:00,43.9,50,3,30,99,3,0,3,0
2023-01-05T14:00,44.3,44,3,20,96,74,24,50,85
2023-01-05T15:00,46.3,72,0,72,95,186,95,91,281.4
2023-01-05T16:00,48.1,23,10,10,25,286,166,120,425.2
2023-01-05T17:00,49.5,77,82,0,10,336,193,143,468.4
2023-01-05T18:00,51.3,99,93,17,18,381,262,119,566.1
2023-01-05T19:00,52.2,100,52,75,41,235,83,152,433.2
2023-01-05T20:00,51.8,54,22,56,1,173,63,110,193
2023-01-05T21:00,50.6,39,20,35,0,106,56,50,262
2023-01-05T22:00,48.1,64,24,70,0,22,11,11,131.6
2023-01-05T23:00,45.4,66,34,59,0,0,0,0,0
2023-01-06T00:00,43.3,54,40,30,0,0,0,0,0
2023-01-06T01:00,41.5,40,20,37,0,0,0,0,0
2023-01-06T02:00,40.2,36,16,36,0,0,0,0,0
2023-01-06T03:00,39.2,33,15,32,0,0,0,0,0
2023-01-06T04:00,38.4,41,18,41,0,0,0,0,0
2023-01-06T05:00,37.9,29,12,30,0,0,0,0,0
2023-01-06T06:00,37.2,11,8,6,0,0,0,0,0
2023-01-06T07:00,37.3,9,2,12,0,0,0,0,0
2023-01-06T08:00,36.9,51,8,71,4,0,0,0,0
2023-01-06T09:00,36.3,86,11,97,59,0,0,0,0
2023-01-06T10:00,36.7,90,13,98,65,0,0,0,0
2023-01-06T11:00,36.8,100,60,99,86,0,0,0,0
2023-01-06T12:00,36.6,100,92,100,92,0,0,0,0
2023-01-06T13:00,36.8,100,100,100,90,2,0,2,0
2023-01-06T14:00,37.8,100,97,100,88,34,2,32,6.2
2023-01-06T15:00,37.5,100,83,99,91,86,10,76,26
2023-01-06T16:00,38.1,100,69,91,74,136,28,108,56.6
2023-01-06T17:00,39,98,58,76,0,170,59,111,112.2
2023-01-06T18:00,39.6,69,36,61,0,177,62,115,139
2023-01-06T19:00,41.2,52,32,38,0,265,144,121,258.9
2023-01-06T20:00,41.4,32,27,12,0,214,125,89,408.4
2023-01-06T21:00,40.9,49,48,9,0,111,58,53,374
2023-01-06T22:00,38.8,67,60,21,0,20,7,13,125
2023-01-06T23:00,37.7,54,31,43,0,0,0,0,0
2023-01-07T00:00,37,86,47,73,0,0,0,0,0
2023-01-07T01:00,36.4,91,49,78,0,0,0,0,0
2023-01-07T02:00,36,99,53,85,0,0,0,0,0
2023-01-07T03:00,35.8,92,59,65,0,0,0,0,0
2023-01-07T04:00,35,96,65,63,0,0,0,0,0
2023-01-07T05:00,34.2,93,67,54,0,0,0,0,0
2023-01-07T06:00,33.9,98,63,63,10,0,0,0,0
2023-01-07T07:00,34.6,71,43,51,5,0,0,0,0
2023-01-07T08:00,34.4,54,35,28,18,0,0,0,0
2023-01-07T09:00,34.3,71,53,27,24,0,0,0,0
2023-01-07T10:00,34.7,71,42,44,22,0,0,0,0
2023-01-07T11:00,34.9,79,36,65,27,0,0,0,0
2023-01-07T12:00,34.8,80,37,68,18,0,0,0,0
2023-01-07T13:00,35,78,38,64,18,1,0,1,0
2023-01-07T14:00,35.7,92,64,27,59,37,7,30,18.5
2023-01-07T15:00,37,100,100,21,85,132,64,68,149.8
2023-01-07T16:00,37.8,100,99,30,94,194,99,95,278.7
2023-01-07T17:00,37.8,100,66,45,89,160,23,137,169.4
2023-01-07T18:00,38,100,64,62,86,174,26,148,40
2023-01-07T19:00,39.3,100,73,82,93,243,111,132,179.3
2023-01-07T20:00,38.5,100,96,86,36,149,44,105,226.9
2023-01-07T21:00,37.7,86,94,3,0,92,27,65,140.4
2023-01-07T22:00,36.1,70,77,2,0,14,5,9,64.1
2023-01-07T23:00,35,79,86,3,0,0,0,0,0
2023-01-08T00:00,34.1,68,76,0,0,0,0,0,0
2023-01-08T01:00,32.3,61,68,0,0,0,0,0,0
2023-01-08T02:00,31.6,78,87,0,0,0,0,0,0
2023-01-08T03:00,31,83,92,0,0,0,0,0,0
2023-01-08T04:00,30.5,90,100,0,0,0,0,0,0
2023-01-08T05:00,29.9,89,99,0,0,0,0,0,0
2023-01-08T06:00,29.5,90,100,0,0,0,0,0,0
2023-01-08T07:00,29.4,90,100,0,0,0,0,0,0
2023-01-08T08:00,29.1,90,100,0,0,0,0,0,0
2023-01-08T09:00,28.8,88,98,0,0,0,0,0,0
2023-01-08T10:00,28.8,89,99,0,0,0,0,0,0
2023-01-08T11:00,28.7,90,100,0,0,0,0,0,0
2023-01-08T12:00,28.8,90,100,0,0,0,0,0,0
2023-01-08T13:00,28.7,90,100,0,1,3,1,2,0
2023-01-08T14:00,29.5,94,100,0,12,76,36,40,154.8
2023-01-08T15:00,31.3,91,100,0,4,205,131,74,393.3
2023-01-08T16:00,33.3,87,97,0,0,315,222,93,565.3
2023-01-08T17:00,35.1,34,38,0,0,394,291,103,664.2
2023-01-08T18:00,36.9,32,36,0,0,415,310,105,716.5
2023-01-08T19:00,37.3,3,3,0,0,392,319,73,778.4
2023-01-08T20:00,37.6,1,1,0,0,303,246,57,822.2
2023-01-08T21:00,36.4,1,1,0,0,166,121,45,731.2
2023-01-08T22:00,34.3,5,0,5,5,31,19,12,279.9
2023-01-08T23:00,32.6,9,0,1,29,0,0,0,0
2023-01-09T00:00,31.8,3,0,0,11,0,0,0,0
2023-01-09T01:00,31.2,0,0,0,1,0,0,0,0
2023-01-09T02:00,30.7,0,0,0,0,0,0,0,0
2023-01-09T03:00,30.3,0,0,0,0,0,0,0,0
2023-01-09T04:00,30,3,0,5,0,0,0,0,0
2023-01-09T05:00,29.8,14,0,24,0,0,0,0,0
2023-01-09T06:00,30.1,53,10,71,5,0,0,0,0
2023-01-09T07:00,30.6,81,20,91,29,0,0,0,0
2023-01-09T08:00,30.5,95,20,88,81,0,0,0,0
2023-01-09T09:00,30.8,80,50,26,65,0,0,0,0
2023-01-09T10:00,30.2,66,73,0,0,0,0,0,0
2023-01-09T11:00,29.6,74,81,0,5,0,0,0,0
2023-01-09T12:00,29.3,88,80,0,53,0,0,0,0
2023-01-09T13:00,28.9,100,87,0,72,2,0,2,0
2023-01-09T14:00,29.3,76,84,0,1,42,4,38,13
2023-01-09T15:00,30,89,99,0,0,99,20,79,48.3
2023-01-09T16:00,31.8,60,67,0,0,209,82,127,139.8
2023-01-09T17:00,34.3,34,38,0,0,329,223,106,375.5
2023-01-09T18:00,37.1,11,12,0,0,416,334,82,672.6
2023-01-09T19:00,38.7,13,14,0,0,378,289,89,778.2
2023-01-09T20:00,39.1,23,26,0,0,264,192,72,689.8
2023-01-09T21:00,37.3,33,37,0,0,113,70,43,494.9
2023-01-09T22:00,34.6,51,57,0,0,21,11,10,160.2
2023-01-09T23:00,33.3,68,76,0,0,0,0,0,0
2023-01-10T00:00,32.6,83,92,0,0,0,0,0,0
2023-01-10T01:00,32.8,87,97,0,0,0,0,0,0
2023-01-10T02:00,32.6,86,95,1,0,0,0,0,0
2023-01-10T03:00,32.9,83,92,1,0,0,0,0,0
2023-01-10T04:00,32.9,81,90,0,0,0,0,0,0
2023-01-10T05:00,33,75,83,0,0,0,0,0,0
2023-01-10T06:00,32.9,68,76,0,0,0,0,0,0
2023-01-10T07:00,33.3,65,72,0,1,0,0,0,0
2023-01-10T08:00,33.3,75,78,1,13,0,0,0,0
2023-01-10T09:00,33.5,87,79,1,52,0,0,0,0
2023-01-10T10:00,33.3,95,70,18,69,0,0,0,0
2023-01-10T11:00,33.1,91,73,9,67,0,0,0,0
2023-01-10T12:00,33.1,86,64,5,84,0,0,0,0
2023-01-10T13:00,33.1,81,56,4,95,2,0,2,0
2023-01-10T14:00,33.3,100,76,51,97,35,2,33,5.8
2023-01-10T15:00,34.1,100,87,62,87,97,12,85,29.8
2023-01-10T16:00,34.3,100,97,78,85,122,25,97,58
2023-01-10T17:00,34.7,100,100,79,90,167,33,134,71.8
2023-01-10T18:00,34.7,100,100,70,71,198,67,131,123.3
2023-01-10T19:00,34.9,100,100,18,43,105,6,99,89.1
2023-01-10T20:00,34.6,100,100,0,81,92,14,78,24.6
2023-01-10T21:00,34.1,100,98,0,100,54,6,48,40.3
2023-01-10T22:00,33.2,100,96,3,97,10,0,10,11.7
2023-01-10T23:00,32.5,100,92,6,46,0,0,0,0
2023-01-11T00:00,32.3,85,82,10,17,0,0,0,0
2023-01-11T01:00,31.5,81,89,1,2,0,0,0,0
2023-01-11T02:00,31.2,80,89,0,0,0,0,0,0
2023-01-11T03:00,30.9,76,84,0,0,0,0,0,0
2023-01-11T04:00,30.8,80,89,0,0,0,0,0,0
2023-01-11T05:00,30.7,77,86,0,0,0,0,0,0
2023-01-11T06:00,30.7,78,87,0,0,0,0,0,0
2023-01-11T07:00,29.7,89,91,0,22,0,0,0,0
2023-01-11T08:00,29.7,90,93,0,20,0,0,0,0
2023-01-11T09:00,29.7,95,87,0,56,0,0,0,0
2023-01-11T10:00,30,88,91,0,21,0,0,0,0
2023-01-11T11:00,30.3,85,94,0,0,0,0,0,0
2023-01-11T12:00,30.5,78,87,0,0,0,0,0,0
2023-01-11T13:00,30.7,83,83,0,29,2,0,2,0
2023-01-11T14:00,32.1,100,89,0,99,42,10,32,38.9
2023-01-11T15:00,34.1,100,94,2,100,87,9,78,58.5
2023-01-11T16:00,36,100,85,6,100,140,12,128,24.3
2023-01-11T17:00,38.7,67,39,3,100,247,90,157,124.2
2023-01-11T18:00,39.9,45,17,0,100,249,70,179,198.2
2023-01-11T19:00,40.5,62,17,28,100,233,47,186,141.7
2023-01-11T20:00,39.9,92,6,95,100,144,16,128,84.2
2023-01-11T21:00,38.8,100,11,100,100,86,7,79,41.8
2023-01-11T22:00,36.9,100,52,100,100,15,0,15,13.6
2023-01-11T23:00,36.1,100,74,100,56,0,0,0,0
2023-01-12T00:00,35.6,100,52,97,0,0,0,0,0
2023-01-12T01:00,34.4,86,44,77,0,0,0,0,0
2023-01-12T02:00,34,66,39,52,0,0,0,0,0
2023-01-12T03:00,33.3,17,7,18,0,0,0,0,0
2023-01-12T04:00,33.2,12,5,12,0,0,0,0,0
2023-01-12T05:00,33,29,18,22,0,0,0,0,0
2023-01-12T06:00,33.1,37,25,24,0,0,0,0,0
2023-01-12T07:00,34.1,59,40,36,3,0,0,0,0
2023-01-12T08:00,34.4,90,54,64,9,0,0,0,0
2023-01-12T09:00,34.6,100,51,94,42,0,0,0,0
2023-01-12T10:00,34.9,67,10,86,22,0,0,0,0
2023-01-12T11:00,34.7,100,58,97,0,0,0,0,0
2023-01-12T12:00,34.7,100,100,97,0,0,0,0,0
2023-01-12T13:00,35,100,100,97,97,1,0,1,0
2023-01-12T14:00,35.8,100,99,61,100,13,0,13,0
2023-01-12T15:00,37.2,100,98,39,100,46,1,45,1.7
2023-01-12T16:00,38.5,100,95,25,100,62,1,61,2.8
2023-01-12T17:00,39.4,100,99,78,100,75,1,74,2.4
2023-01-12T18:00,40.8,100,98,86,100,121,7,114,9.6
2023-01-12T19:00,40.5,100,98,99,100,73,2,71,11.4
2023-01-12T20:00,40.6,100,82,98,100,46,0,46,1.9
2023-01-12T21:00,40.5,100,87,100,100,24,0,24,0
2023-01-12T22:00,40.2,100,75,100,100,5,0,5,0
2023-01-12T23:00,40.7,100,97,100,100,0,0,0,0
2023-01-13T00:00,41.5,100,100,100,100,0,0,0,0
2023-01-13T01:00,42.7,100,100,100,100,0,0,0,0
2023-01-13T02:00,43.5,100,100,100,100,0,0,0,0
2023-01-13T03:00,43.9,100,100,100,100,0,0,0,0
2023-01-13T04:00,43.8,100,100,100,100,0,0,0,0
2023-01-13T05:00,43.5,100,100,100,100,0,0,0,0
2023-01-13T06:00,43.2,100,100,100,100,0,0,0,0
2023-01-13T07:00,42.4,100,100,100,100,0,0,0,0
2023-01-13T08:00,42,100,100,100,99,0,0,0,0
2023-01-13T09:00,41.4,100,100,100,94,0,0,0,0
2023-01-13T10:00,39.5,100,100,87,43,0,0,0,0
2023-01-13T11:00,36.9,100,97,67,55,0,0,0,0
2023-01-13T12:00,34.2,100,95,75,38,0,0,0,0
2023-01-13T13:00,33,100,97,99,48,2,0,2,0
2023-01-13T14:00,32.4,100,96,95,43,26,2,24,5
2023-01-13T15:00,32.3,100,94,91,33,65,16,49,38.3
2023-01-13T16:00,32.4,100,98,77,4,114,16,98,54.5
2023-01-13T17:00,32.2,100,100,49,0,131,10,121,32.6
2023-01-13T18:00,32.1,100,100,76,0,167,14,153,27.8
2023-01-13T19:00,32,100,100,88,0,110,4,106,21.8
2023-01-13T20:00,31.3,100,100,92,0,93,1,92,5.3
2023-01-13T21:00,30.3,90,100,0,0,59,2,57,6.4
2023-01-13T22:00,29.6,100,100,80,0,14,0,14,3.8
2023-01-13T23:00,29.1,100,100,69,1,0,0,0,0
2023-01-14T00:00,28.7,100,100,37,5,0,0,0,0
2023-01-14T01:00,28.1,100,100,35,2,0,0,0,0
2023-01-14T02:00,27.7,100,100,30,0,0,0,0,0
2023-01-14T03:00,27.1,100,100,28,0,0,0,0,0
2023-01-14T04:00,26.4,100,100,42,0,0,0,0,0
2023-01-14T05:00,25.7,100,100,52,0,0,0,0,0
2023-01-14T06:00,25.2,100,100,43,0,0,0,0,0
2023-01-14T07:00,25.7,100,100,35,0,0,0,0,0
2023-01-14T08:00,25.3,100,100,34,0,0,0,0,0
2023-01-14T09:00,24.8,100,100,26,0,0,0,0,0
2023-01-14T10:00,24.4,99,100,15,0,0,0,0,0
2023-01-14T11:00,24,100,100,8,32,0,0,0,0
2023-01-14T12:00,23.5,99,100,3,23,0,0,0,0
2023-01-14T13:00,23.2,98,100,5,18,2,0,2,0
2023-01-14T14:00,23.2,100,100,4,24,35,0,35,0
2023-01-14T15:00,23.4,90,100,0,0,79,6,73,11.6
2023-01-14T16:00,23.8,90,100,0,0,124,2,122,13.4
2023-01-14T17:00,24.2,90,100,0,0,155,15,140,19.5
2023-01-14T18:00,24.3,90,100,0,0,173,14,159,33.7
2023-01-14T19:00,24.8,90,100,0,0,149,24,125,47.5
2023-01-14T20:00,24.5,90,100,0,0,112,2,110,34.6
2023-01-14T21:00,23.7,90,100,0,0,66,0,66,0.9
2023-01-14T22:00,22.8,90,100,0,0,16,0,16,0
2023-01-14T23:00,22.3,90,100,0,0,0,0,0,0
2023-01-15T00:00,22.1,90,100,0,0,0,0,0,0
2023-01-15T01:00,22.1,90,100,0,0,0,0,0,0
2023-01-15T02:00,22.3,90,100,0,0,0,0,0,0
2023-01-15T03:00,22.4,90,100,0,0,0,0,0,0
2023-01-15T04:00,22.4,86,95,0,0,0,0,0,0
2023-01-15T05:00,22.4,89,99,0,0,0,0,0,0
2023-01-15T06:00,22.1,86,95,0,0,0,0,0,0
2023-01-15T07:00,22.2,90,100,0,0,0,0,0,0
2023-01-15T08:00,21.8,90,100,0,0,0,0,0,0
2023-01-15T09:00,21.5,90,100,0,0,0,0,0,0
2023-01-15T10:00,21.3,90,100,0,0,0,0,0,0
2023-01-15T11:00,21.1,90,100,0,0,0,0,0,0
2023-01-15T12:00,20.9,90,100,0,0,0,0,0,0
2023-01-15T13:00,20.8,90,100,0,0,2,0,2,0
2023-01-15T14:00,21.6,90,100,0,0,44,1,43,0.9
2023-01-15T15:00,23.4,90,100,0,0,130,17,113,35.6
2023-01-15T16:00,25,90,100,0,0,203,17,186,53.1
2023-01-15T17:00,26.5,90,100,0,0,261,55,206,76.4
2023-01-15T18:00,27.9,90,100,0,0,335,152,183,240.3
2023-01-15T19:00,27.4,90,100,0,0,283,113,170,322.3
2023-01-15T20:00,27.3,88,98,0,0,214,75,139,248.4
2023-01-15T21:00,26.6,80,89,0,0,144,58,86,250.4
2023-01-15T22:00,25.1,69,77,0,0,37,15,22,167.3
2023-01-15T23:00,23.7,72,80,0,0,0,0,0,0
2023-01-16T00:00,22.5,69,77,0,0,0,0,0,0
2023-01-16T01:00,21.7,84,93,0,0,0,0,0,0
2023-01-16T02:00,21.2,81,90,0,0,0,0,0,0
2023-01-16T03:00,21.2,80,89,0,0,0,0,0,0
2023-01-16T04:00,21.4,79,88,0,0,0,0,0,0
2023-01-16T05:00,21.2,73,81,0,0,0,0,0,0
2023-01-16T06:00,21,60,67,0,0,0,0,0,0
2023-01-16T07:00,20.8,50,56,0,0,0,0,0,0
2023-01-16T08:00,20.6,39,43,0,0,0,0,0,0
2023-01-16T09:00,20.7,21,23,0,0,0,0,0,0
2023-01-16T10:00,20.3,52,58,0,0,0,0,0,0
2023-01-16T11:00,20.1,51,57,0,0,0,0,0,0
2023-01-16T12:00,20,51,57,0,0,0,0,0,0
2023-01-16T13:00,20.2,60,67,0,0,6,3,3,0
2023-01-16T14:00,22.6,46,50,0,3,108,74,34,321.3
2023-01-16T15:00,26.5,26,14,0,45,255,197,58,636.2
2023-01-16T16:00,30.6,30,5,0,86,378,310,68,778.6
2023-01-16T17:00,33.8,29,1,0,94,450,376,74,852.5
2023-01-16T18:00,35.6,6,2,0,13,465,391,74,878.4
2023-01-16T19:00,35.5,15,0,0,49,410,331,79,844.8
2023-01-16T20:00,35.1,14,0,0,46,319,253,66,786.6
2023-01-16T21:00,33.5,0,0,0,0,184,133,51,697
2023-01-16T22:00,30.6,0,0,0,0,46,29,17,360.3
2023-01-16T23:00,29.3,0,0,0,0,0,0,0,0
2023-01-17T00:00,28.4,0,0,0,0,0,0,0,0
2023-01-17T01:00,27.4,1,0,0,2,0,0,0,0
2023-01-17T02:00,27.9,21,0,0,69,0,0,0,0
2023-01-17T03:00,26.2,24,0,0,79,0,0,0,0
2023-01-17T04:00,27.3,73,48,0,99,0,0,0,0
2023-01-17T05:00,26.7,52,24,1,100,0,0,0,0
2023-01-17T06:00,26.5,31,0,2,100,0,0,0,0
2023-01-17T07:00,26.5,28,0,12,70,0,0,0,0
2023-01-17T08:00,26.4,14,0,9,30,0,0,0,0
2023-01-17T09:00,26.6,48,0,45,70,0,0,0,0
2023-01-17T10:00,27.1,80,0,91,86,0,0,0,0
2023-01-17T11:00,28.3,100,13,99,100,0,0,0,0
2023-01-17T12:00,30,100,43,99,100,0,0,0,0
2023-01-17T13:00,32.1,100,74,100,100,1,0,1,0
2023-01-17T14:00,34,100,100,100,100,15,0,15,0
2023-01-17T15:00,32.2,100,100,99,96,29,0,29,0
2023-01-17T16:00,32.8,100,100,80,25,38,0,38,0
2023-01-17T17:00,34,100,100,70,17,38,0,38,0
2023-01-17T18:00,36.2,100,100,35,11,84,16,68,18.9
2023-01-17T19:00,39.6,100,100,77,0,82,2,80,22
2023-01-17T20:00,39.9,100,100,72,0,53,2,51,4.4
2023-01-17T21:00,39.7,100,100,54,0,33,0,33,2.9
2023-01-17T22:00,39,98,84,38,0,7,0,7,0
2023-01-17T23:00,38.8,100,80,77,0,0,0,0,0
2023-01-18T00:00,37.8,100,90,71,0,0,0,0,0
2023-01-18T01:00,37.8,100,85,50,1,0,0,0,0
2023-01-18T02:00,37.9,100,66,90,24,0,0,0,0
2023-01-18T03:00,38.1,100,97,94,12,0,0,0,0
2023-01-18T04:00,38.6,100,83,92,1,0,0,0,0
2023-01-18T05:00,38.7,100,68,98,0,0,0,0,0
2023-01-18T06:00,38.5,100,93,94,0,0,0,0,0
2023-01-18T07:00,37.9,100,96,87,0,0,0,0,0
2023-01-18T08:00,37.8,100,99,72,0,0,0,0,0
2023-01-18T09:00,37.6,100,99,86,0,0,0,0,0
2023-01-18T10:00,37.1,96,62,67,0,0,0,0,0
2023-01-18T11:00,36.6,100,62,83,0,0,0,0,0
2023-01-18T12:00,36.1,100,98,100,0,0,0,0,0
2023-01-18T13:00,36,100,97,100,0,2,0,2,0
2023-01-18T14:00,36.4,100,99,99,0,30,4,26,14.9
2023-01-18T15:00,37,100,100,99,0,58,0,58,14.6
2023-01-18T16:00,38.6,100,100,99,0,90,6,84,6.2
2023-01-18T17:00,39.3,100,100,96,0,100,11,89,21.8
2023-01-18T18:00,39.3,100,100,92,0,87,1,86,14.3
2023-01-18T19:00,39.6,100,100,97,0,78,0,78,0.3
2023-01-18T20:00,38.9,100,100,94,0,32,0,32,0
2023-01-18T21:00,38.7,100,100,85,0,27,0,27,0
2023-01-18T22:00,38,100,98,68,0,9,0,9,0
2023-01-18T23:00,37.7,100,97,70,0,0,0,0,0
2023-01-19T00:00,37.5,100,99,70,5,0,0,0,0
2023-01-19T01:00,36.6,100,99,61,3,0,0,0,0
2023-01-19T02:00,36.2,100,100,41,0,0,0,0,0
2023-01-19T03:00,35.8,100,96,19,29,0,0,0,0
2023-01-19T04:00,35.5,88,96,0,5,0,0,0,0
2023-01-19T05:00,34.9,100,86,0,97,0,0,0,0
2023-01-19T06:00,34.9,100,98,0,100,0,0,0,0
2023-01-19T07:00,35.3,100,91,0,100,0,0,0,0
2023-01-19T08:00,34.9,100,92,0,100,0,0,0,0
2023-01-19T09:00,35.2,100,90,3,100,0,0,0,0
2023-01-19T10:00,34.3,100,73,55,100,0,0,0,0
2023-01-19T11:00,34.2,100,62,96,100,0,0,0,0
2023-01-19T12:00,34.2,100,62,100,100,0,0,0,0
2023-01-19T13:00,34.3,100,35,100,100,2,0,2,0
2023-01-19T14:00,35,98,16,89,100,21,0,21,0
2023-01-19T15:00,35.1,100,38,100,100,40,0,40,0
2023-01-19T16:00,35.3,100,78,95,100,31,0,31,0
2023-01-19T17:00,35.7,100,100,100,100,45,0,45,0
2023-01-19T18:00,36.1,100,100,100,100,51,0,51,0
2023-01-19T19:00,36.3,100,100,99,100,22,0,22,0
2023-01-19T20:00,36.5,100,100,92,99,18,0,18,0
2023-01-19T21:00,36.9,100,99,89,9,26,0,26,0
2023-01-19T22:00,37.1,100,100,59,2,5,1,4,1.9
2023-01-19T23:00,37.4,100,100,18,0,0,0,0,0
2023-01-20T00:00,37.6,94,98,9,0,0,0,0,0
2023-01-20T01:00,38.1,91,96,7,0,0,0,0,0
2023-01-20T02:00,38.3,69,72,7,0,0,0,0,0
2023-01-20T03:00,38.1,50,42,8,24,0,0,0,0
2023-01-20T04:00,38,78,56,10,71,0,0,0,0
2023-01-20T05:00,38.1,100,75,93,72,0,0,0,0
2023-01-20T06:00,38.4,100,61,100,97,0,0,0,0
2023-01-20T07:00,38.2,100,99,99,84,0,0,0,0
2023-01-20T08:00,38.9,100,99,82,50,0,0,0,0
2023-01-20T09:00,39.4,100,94,77,24,0,0,0,0
2023-01-20T10:00,38.7,100,72,73,30,0,0,0,0
2023-01-20T11:00,37.2,100,35,90,64,0,0,0,0
2023-01-20T12:00,36.3,100,89,93,84,0,0,0,0
2023-01-20T13:00,35.9,100,96,98,88,1,0,1,0
2023-01-20T14:00,36,100,100,98,59,22,0,22,0
2023-01-20T15:00,36.1,100,100,98,76,51,0,51,0
2023-01-20T16:00,36.7,100,100,98,75,89,1,88,0.4
2023-01-20T17:00,37.8,100,99,99,68,119,9,110,11.5
2023-01-20T18:00,38.2,100,100,93,76,132,8,124,19.6
2023-01-20T19:00,37.9,100,99,90,81,111,8,103,17.1
2023-01-20T20:00,37.5,100,99,97,68,79,13,66,29.8
2023-01-20T21:00,36.1,100,99,98,34,30,0,30,19.8
2023-01-20T22:00,35.1,100,65,89,6,11,0,11,0
2023-01-20T23:00,34.6,100,88,92,6,0,0,0,0
2023-01-21T00:00,34.1,100,95,99,0,0,0,0,0
2023-01-21T01:00,33.8,100,99,100,0,0,0,0,0
2023-01-21T02:00,33.1,100,98,99,0,0,0,0,0
2023-01-21T03:00,32.4,100,99,96,0,0,0,0,0
2023-01-21T04:00,32,100,99,90,0,0,0,0,0
2023-01-21T05:00,31.5,100,98,47,0,0,0,0,0
2023-01-21T06:00,31.2,84,88,8,0,0,0,0,0
2023-01-21T07:00,31.3,83,91,2,0,0,0,0,0
2023-01-21T08:00,31.5,84,92,2,0,0,0,0,0
2023-01-21T09:00,31.2,83,92,0,0,0,0,0,0
2023-01-21T10:00,31.3,68,75,0,0,0,0,0,0
2023-01-21T11:00,31,68,75,0,0,0,0,0,0
2023-01-21T12:00,30.8,79,88,0,0,0,0,0,0
2023-01-21T13:00,31.1,69,77,0,0,5,1,4,0
2023-01-21T14:00,31.9,76,84,0,0,55,16,39,68.3
2023-01-21T15:00,33,72,76,0,13,144,56,88,154.8
2023-01-21T16:00,34.1,90,97,0,8,199,68,131,196.5
2023-01-21T17:00,34.3,90,100,0,0,148,2,146,90.4
2023-01-21T18:00,34.7,90,100,0,0,147,3,144,0.9
2023-01-21T19:00,35.6,90,100,0,0,160,20,140,27.1
2023-01-21T20:00,35.6,100,100,0,40,117,9,108,38.7
2023-01-21T21:00,35.1,96,98,0,25,65,2,63,13
2023-01-21T22:00,34.2,89,95,0,13,23,7,16,27.4
2023-01-21T23:00,33.3,100,95,0,68,0,0,0,0
2023-01-22T00:00,32.5,93,82,5,53,0,0,0,0
2023-01-22T01:00,32.2,100,73,44,88,0,0,0,0
2023-01-22T02:00,31.6,100,81,68,97,0,0,0,0
2023-01-22T03:00,31.5,100,71,57,60,0,0,0,0
2023-01-22T04:00,31.3,64,71,0,0,0,0,0,0
2023-01-22T05:00,31.1,60,67,0,0,0,0,0,0
2023-01-22T06:00,30.6,58,64,1,0,0,0,0,0
2023-01-22T07:00,31.6,50,56,0,0,0,0,0,0
2023-01-22T08:00,31.8,57,61,2,3,0,0,0,0
2023-01-22T09:00,31.5,57,61,1,4,0,0,0,0
2023-01-22T10:00,31.5,68,72,0,12,0,0,0,0
2023-01-22T11:00,31.6,100,77,22,68,0,0,0,0
2023-01-22T12:00,31.5,100,90,17,89,0,0,0,0
2023-01-22T13:00,31.5,95,73,0,97,6,2,4,0
2023-01-22T14:00,33,100,42,87,100,90,41,49,167.7
2023-01-22T15:00,35.7,73,48,0,100,202,93,109,307.4
2023-01-22T16:00,37.8,100,93,43,100,277,95,182,291.4
2023-01-22T17:00,39.1,100,97,99,99,256,43,213,169.9
2023-01-22T18:00,39.7,100,100,100,98,201,11,190,54.4
2023-01-22T19:00,37.4,84,26,58,85,102,4,98,10.6
2023-01-22T20:00,37.1,89,11,87,90,133,28,105,40
2023-01-22T21:00,36.5,80,6,82,86,115,36,79,122.4
2023-01-22T22:00,35.1,100,19,97,100,17,4,13,89.4
2023-01-22T23:00,34.2,71,9,99,11,0,0,0,0
2023-01-23T00:00,33.8,100,53,98,100,0,0,0,0
2023-01-23T01:00,33.7,100,60,95,90,0,0,0,0
2023-01-23T02:00,33.6,100,71,98,100,0,0,0,0
2023-01-23T03:00,33.3,100,79,100,100,0,0,0,0
2023-01-23T04:00,33.2,100,67,99,97,0,0,0,0
2023-01-23T05:00,33.1,89,23,99,30,0,0,0,0
2023-01-23T06:00,33.1,97,40,100,4,0,0,0,0
2023-01-23T07:00,33.1,100,96,100,6,0,0,0,0
2023-01-23T08:00,33.3,100,97,100,6,0,0,0,0
2023-01-23T09:00,33,100,99,100,12,0,0,0,0
2023-01-23T10:00,32.9,100,100,100,8,0,0,0,0
2023-01-23T11:00,32.9,100,100,100,40,0,0,0,0
2023-01-23T12:00,32.8,100,100,99,29,0,0,0,0
2023-01-23T13:00,32.8,100,100,99,70,3,0,3,0
2023-01-23T14:00,33.3,100,100,98,94,42,0,42,0
2023-01-23T15:00,33.8,100,96,95,98,85,7,78,12.1
2023-01-23T16:00,34,100,100,66,77,118,6,112,20.1
2023-01-23T17:00,34.3,100,99,9,19,168,15,153,25
2023-01-23T18:00,33.7,92,100,4,0,133,1,132,17.1
2023-01-23T19:00,32.7,98,100,13,0,142,15,127,18
2023-01-23T20:00,32.4,89,96,4,0,102,2,100,20.7
2023-01-23T21:00,32,67,74,0,0,73,7,66,15.1
2023-01-23T22:00,31.5,81,87,4,0,27,5,22,32.5
2023-01-23T23:00,31,72,79,1,0,0,0,0,0.2
2023-01-24T00:00,30.8,81,87,5,0,0,0,0,0
2023-01-24T01:00,31.3,76,78,9,0,0,0,0,0
2023-01-24T02:00,31.5,72,79,2,0,0,0,0,0
2023-01-24T03:00,31.6,66,73,0,0,0,0,0,0
2023-01-24T04:00,32,81,90,0,0,0,0,0,0
2023-01-24T05:00,32.4,83,91,0,4,0,0,0,0
2023-01-24T06:00,32.4,100,93,0,74,0,0,0,0
2023-01-24T07:00,32.9,100,87,0,86,0,0,0,0
2023-01-24T08:00,32.9,100,81,0,96,0,0,0,0
2023-01-24T09:00,32.9,97,75,0,97,0,0,0,0
2023-01-24T10:00,32.4,86,68,0,83,0,0,0,0
2023-01-24T11:00,32.3,75,66,26,0,0,0,0,0
2023-01-24T12:00,31.7,100,91,99,0,0,0,0,0
2023-01-24T13:00,31.8,100,98,91,0,3,0,3,0
2023-01-24T14:00,32.7,100,100,82,0,52,7,45,20.2
2023-01-24T15:00,34.1,100,95,64,0,113,25,88,66.9
2023-01-24T16:00,35.2,100,96,28,0,176,29,147,80.6
2023-01-24T17:00,35.7,98,86,35,0,184,33,151,72.6
2023-01-24T18:00,36.1,85,67,40,3,199,27,172,60.2
2023-01-24T19:00,36.9,77,48,57,0,231,73,158,105.5
2023-01-24T20:00,36.9,90,63,56,0,226,100,126,226.6
2023-01-24T21:00,36.2,52,55,1,6,143,57,86,257.9
2023-01-24T22:00,34.7,94,81,26,17,54,26,28,202.4
2023-01-24T23:00,33.3,100,88,36,0,0,0,0,1.7
2023-01-25T00:00,32.3,86,71,36,0,0,0,0,0
2023-01-25T01:00,31.3,69,43,28,46,0,0,0,0
2023-01-25T02:00,30.7,67,40,2,99,0,0,0,0
2023-01-25T03:00,30.5,68,39,4,100,0,0,0,0
2023-01-25T04:00,29.9,52,54,6,0,0,0,0,0
2023-01-25T05:00,29.7,76,48,4,100,0,0,0,0
2023-01-25T06:00,29.3,53,26,0,100,0,0,0,0
2023-01-25T07:00,29.7,44,15,0,100,0,0,0,0
2023-01-25T08:00,29.7,41,12,1,100,0,0,0,0
2023-01-25T09:00,29.5,65,7,47,100,0,0,0,0
2023-01-25T10:00,29.5,97,10,96,100,0,0,0,0
2023-01-25T11:00,29.7,92,2,100,100,0,0,0,0
2023-01-25T12:00,29.9,90,0,100,100,0,0,0,0
2023-01-25T13:00,30.1,90,0,100,100,3,0,3,0
2023-01-25T14:00,30.9,92,2,100,100,38,0,38,0
2023-01-25T15:00,31.7,95,5,100,100,75,1,74,0.5
2023-01-25T16:00,33,100,19,100,100,154,10,144,13.8
2023-01-25T17:00,34.5,100,46,100,100,191,15,176,30.4
2023-01-25T18:00,34.9,100,80,100,100,124,7,117,24.5
2023-01-25T19:00,33.3,100,32,94,80,56,1,55,7.6
2023-01-25T20:00,33.4,100,74,73,12,56,2,54,1.4
2023-01-25T21:00,34.1,100,95,70,0,68,12,56,28.2
2023-01-25T22:00,35.5,100,99,77,8,16,1,15,28.8
2023-01-25T23:00,36.7,94,54,74,4,0,0,0,0
2023-01-26T00:00,36.6,100,80,90,10,0,0,0,0
2023-01-26T01:00,37.2,100,88,92,0,0,0,0,0
2023-01-26T02:00,37.7,100,97,96,0,0,0,0,0
2023-01-26T03:00,38.4,100,98,82,0,0,0,0,0
2023-01-26T04:00,39.1,100,95,69,0,0,0,0,0
2023-01-26T05:00,39.7,100,95,35,0,0,0,0,0
2023-01-26T06:00,40.2,100,87,46,0,0,0,0,0
2023-01-26T07:00,39.2,65,57,22,0,0,0,0,0
2023-01-26T08:00,38.9,92,97,8,0,0,0,0,0
2023-01-26T09:00,38.7,100,100,46,0,0,0,0,0
2023-01-26T10:00,38.5,100,97,83,0,0,0,0,0
2023-01-26T11:00,37,100,88,79,0,0,0,0,0
2023-01-26T12:00,35.7,100,90,69,0,0,0,0,0
2023-01-26T13:00,35,100,91,69,5,4,0,4,0
2023-01-26T14:00,34.9,100,93,68,11,45,4,41,10.4
2023-01-26T15:00,34.5,100,99,96,12,119,19,100,42.9
2023-01-26T16:00,33.9,100,98,78,3,176,43,133,89.8
2023-01-26T17:00,33.4,100,99,54,0,188,8,180,62.4
2023-01-26T18:00,33.3,100,100,50,0,202,31,171,36.7
2023-01-26T19:00,34,100,99,45,0,163,29,134,66.7
2023-01-26T20:00,33.8,100,96,55,1,138,21,117,61.1
2023-01-26T21:00,33.2,100,99,61,49,85,13,72,51.6
2023-01-26T22:00,32.3,100,88,49,68,42,11,31,63.3
2023-01-26T23:00,31.4,100,81,75,18,0,0,0,1.5
2023-01-27T00:00,30.1,100,57,82,0,0,0,0,0
2023-01-27T01:00,29.6,82,32,89,0,0,0,0,0
2023-01-27T02:00,29,90,39,91,0,0,0,0,0
2023-01-27T03:00,29.1,96,42,97,0,0,0,0,0
2023-01-27T04:00,29.2,99,45,97,0,0,0,0,0
2023-01-27T05:00,29.3,96,43,96,0,0,0,0,0
2023-01-27T06:00,29,100,56,95,0,0,0,0,0
2023-01-27T07:00,29.7,100,79,96,0,0,0,0,0
2023-01-27T08:00,29.7,100,86,92,0,0,0,0,0
2023-01-27T09:00,29.6,100,81,91,0,0,0,0,0
2023-01-27T10:00,29.6,79,49,58,0,0,0,0,0
2023-01-27T11:00,29.5,100,85,54,0,0,0,0,0
2023-01-27T12:00,29.7,100,98,53,0,0,0,0,0
2023-01-27T13:00,30.5,65,49,34,0,6,0,6,0
2023-01-27T14:00,32.1,35,13,39,0,73,11,62,25.7
2023-01-27T15:00,33.3,99,69,62,0,186,72,114,146.4
2023-01-27T16:00,34.4,100,84,43,0,316,164,152,331.7
2023-01-27T17:00,35.3,97,98,15,0,323,119,204,343.1
2023-01-27T18:00,35.6,91,98,5,0,243,43,200,167.3
2023-01-27T19:00,36.3,94,95,14,0,228,32,196,66.6
2023-01-27T20:00,36.8,100,89,40,0,255,85,170,149.7
2023-01-27T21:00,36.2,100,90,67,57,146,41,105,203.6
2023-01-27T22:00,34.5,100,81,19,98,48,10,38,111.6
2023-01-27T23:00,32.4,56,18,16,100,1,0,1,1.9
2023-01-28T00:00,31,78,1,79,99,0,0,0,0
2023-01-28T01:00,30.5,86,0,98,90,0,0,0,0
2023-01-28T02:00,30.3,84,0,99,83,0,0,0,0
2023-01-28T03:00,30.3,84,0,97,86,0,0,0,0
2023-01-28T04:00,30.6,91,9,100,77,0,0,0,0
2023-01-28T05:00,31.5,85,21,99,22,0,0,0,0
2023-01-28T06:00,32.4,36,0,60,0,0,0,0,0
2023-01-28T07:00,32.8,53,46,18,3,0,0,0,0
2023-01-28T08:00,32.8,100,79,85,0,0,0,0,0
2023-01-28T09:00,33.2,100,95,94,31,0,0,0,0
2023-01-28T10:00,34.3,100,72,68,1,0,0,0,0
2023-01-28T11:00,35.3,66,56,26,0,0,0,0,0
2023-01-28T12:00,36.2,24,22,7,0,0,0,0,0
2023-01-28T13:00,36.4,21,22,2,0,7,1,6,0
2023-01-28T14:00,36.9,70,78,0,0,62,8,54,32.5
2023-01-28T15:00,37,59,66,0,0,167,55,112,107.7
2023-01-28T16:00,37.4,85,78,0,48,264,127,137,251.7
2023-01-28T17:00,38.1,100,87,13,100,292,108,184,271.2
2023-01-28T18:00,39,100,89,72,100,329,152,177,273.5
2023-01-28T19:00,41.2,100,68,93,100,264,59,205,229.1
2023-01-28T20:00,41,100,33,95,100,177,15,162,74.9
2023-01-28T21:00,39.5,83,21,67,79,132,27,105,64.8
2023-01-28T22:00,38.6,71,5,73,76,56,19,37,120.4
2023-01-28T23:00,37,75,1,87,73,1,0,1,5
2023-01-29T00:00,36.1,76,1,100,51,0,0,0,0
2023-01-29T01:00,34.8,64,2,100,8,0,0,0,0
2023-01-29T02:00,33.3,65,2,97,15,0,0,0,0
2023-01-29T03:00,32,50,0,81,3,0,0,0,0
2023-01-29T04:00,31,55,0,87,8,0,0,0,0
2023-01-29T05:00,30.7,48,0,79,1,0,0,0,0
2023-01-29T06:00,30.6,70,20,86,0,0,0,0,0
2023-01-29T07:00,31.9,55,26,53,0,0,0,0,0
2023-01-29T08:00,33.3,29,8,29,16,0,0,0,0
2023-01-29T09:00,34.7,46,3,24,95,0,0,0,0
2023-01-29T10:00,36,72,1,70,97,0,0,0,0
2023-01-29T11:00,37.7,86,0,96,96,0,0,0,0
2023-01-29T12:00,39,87,0,97,97,0,0,0,0
2023-01-29T13:00,39.5,90,1,99,100,4,0,4,0
2023-01-29T14:00,40.6,89,0,100,95,38,1,37,2.5
2023-01-29T15:00,41.4,90,3,100,90,61,0,61,2.5
2023-01-29T16:00,42,100,41,100,22,73,0,73,0
2023-01-29T17:00,41.7,100,86,90,5,94,21,73,17
2023-01-29T18:00,42.3,85,50,66,0,185,76,109,99
2023-01-29T19:00,43.1,98,72,56,0,197,83,114,175.1
2023-01-29T20:00,43.1,100,99,79,0,116,40,76,148.4
2023-01-29T21:00,42.5,100,98,91,0,49,2,47,53.4
2023-01-29T22:00,41.7,100,100,97,0,20,2,18,8.2
2023-01-29T23:00,40.9,100,100,97,0,0,0,0,0.4
2023-01-30T00:00,40.4,100,100,100,0,0,0,0,0
2023-01-30T01:00,39.4,100,100,96,0,0,0,0,0
2023-01-30T02:00,38.7,100,100,65,0,0,0,0,0
2023-01-30T03:00,37.2,97,99,11,3,0,0,0,0
2023-01-30T04:00,35.3,92,99,0,9,0,0,0,0
2023-01-30T05:00,33.7,100,99,0,40,0,0,0,0
2023-01-30T06:00,32.2,100,100,0,90,0,0,0,0
2023-01-30T07:00,30.6,100,100,0,100,0,0,0,0
2023-01-30T08:00,30.2,100,100,0,96,0,0,0,0
2023-01-30T09:00,30,100,100,21,66,0,0,0,0
2023-01-30T10:00,30,100,100,74,30,0,0,0,0
2023-01-30T11:00,30.1,100,100,40,2,0,0,0,0
2023-01-30T12:00,30.1,100,100,77,0,0,0,0,0
2023-01-30T13:00,30.3,100,100,47,0,4,0,4,0
2023-01-30T14:00,31,100,100,36,0,62,6,56,12.9
2023-01-30T15:00,32.6,100,100,100,0,168,40,128,86.8
2023-01-30T16:00,33.4,100,100,99,0,113,3,110,71.8
2023-01-30T17:00,34,100,100,96,0,114,8,106,6
2023-01-30T18:00,34.7,100,100,94,0,134,17,117,27.2
2023-01-30T19:00,34.4,100,98,93,0,88,0,88,16.9
2023-01-30T20:00,34.1,100,95,82,0,85,12,73,14.1
2023-01-30T21:00,33.3,100,94,93,0,63,6,57,28.2
2023-01-30T22:00,32.4,100,90,95,0,20,2,18,18.5
2023-01-30T23:00,31.7,100,65,86,0,1,0,1,0.5
2023-01-31T00:00,31.3,83,37,82,0,0,0,0,0
2023-01-31T01:00,31.5,54,4,84,0,0,0,0,0
2023-01-31T02:00,31.1,60,12,82,0,0,0,0,0
2023-01-31T03:00,30.8,63,10,90,0,0,0,0,0
2023-01-31T04:00,30.7,69,19,87,0,0,0,0,0
2023-01-31T05:00,30.6,96,50,85,0,0,0,0,0
2023-01-31T06:00,30.3,100,88,82,0,0,0,0,0
2023-01-31T07:00,30.3,100,100,72,0,0,0,0,0
2023-01-31T08:00,29.7,100,98,62,0,0,0,0,0
2023-01-31T09:00,28.8,100,88,38,0,0,0,0,0
2023-01-31T10:00,27.9,100,96,23,0,0,0,0,0
2023-01-31T11:00,27,84,91,3,0,0,0,0,0
2023-01-31T12:00,26.1,87,93,5,0,0,0,0,0
2023-01-31T13:00,25.5,85,83,17,0,12,4,8,0
2023-01-31T14:00,25.9,92,87,23,0,106,48,58,179.1
2023-01-31T15:00,26.5,98,97,18,0,221,126,95,335.9
2023-01-31T16:00,27.4,100,89,37,0,325,207,118,452.3
2023-01-31T17:00,27.9,100,80,49,0,323,187,136,441
2023-01-31T18:00,28.5,100,81,54,0,367,212,155,408.6
2023-01-31T19:00,28.1,100,84,64,0,318,102,216,324.8
2023-01-31T20:00,27.8,100,85,65,0,232,77,155,200.1
2023-01-31T21:00,26.9,100,89,51,0,150,46,104,180.7
2023-01-31T22:00,25.7,100,96,65,0,69,25,44,178.2
2023-01-31T23:00,24.1,100,72,74,0,2,0,2,10.6
2023-02-01T00:00,22.5,100,76,96,0,0,0,0,0
2023-02-01T01:00,21.9,100,73,91,0,0,0,0,0
2023-02-01T02:00,21.5,97,49,88,0,0,0,0,0
2023-02-01T03:00,21.2,89,42,86,0,0,0,0,0
2023-02-01T04:00,20.7,53,4,82,0,0,0,0,0
2023-02-01T05:00,20,52,0,87,0,0,0,0,0
2023-02-01T06:00,19.5,32,3,48,0,0,0,0,0
2023-02-01T07:00,20.6,12,12,1,2,0,0,0,0
2023-02-01T08:00,19.8,30,33,0,0,0,0,0,0
2023-02-01T09:00,19.3,33,36,1,0,0,0,0,0
2023-02-01T10:00,13.4,12,13,1,0,0,0,0,0
2023-02-01T11:00,18.6,29,32,1,0,0,0,0,0
2023-02-01T12:00,19,39,43,1,0,0,0,0,0
2023-02-01T13:00,19.1,47,52,0,0,15,6,9,0
2023-02-01T14:00,20.8,60,67,0,0,135,75,60,270.1
2023-02-01T15:00,23.2,77,86,0,0,278,186,92,505.5
2023-02-01T16:00,24.7,89,99,0,0,388,261,127,601.9
2023-02-01T17:00,26.4,90,100,0,0,459,303,156,619.4
2023-02-01T18:00,27.9,87,97,0,0,470,286,184,606.8
2023-02-01T19:00,28.8,91,100,1,0,341,122,219,413.2
2023-02-01T20:00,29.3,92,100,3,0,277,96,181,242.1
2023-02-01T21:00,29.2,91,100,1,0,154,38,116,193.2
2023-02-01T22:00,28.5,82,90,1,0,61,7,54,90.9
2023-02-01T23:00,27.4,61,65,4,0,2,0,2,3.1
2023-02-02T00:00,26.7,36,40,0,0,0,0,0,0
2023-02-02T01:00,26,22,24,0,0,0,0,0,0
2023-02-02T02:00,23.6,11,11,1,0,0,0,0,0
2023-02-02T03:00,23.1,21,4,28,1,0,0,0,0
2023-02-02T04:00,22.5,17,7,15,6,0,0,0,0
2023-02-02T05:00,22.2,45,13,45,20,0,0,0,0
2023-02-02T06:00,21.8,68,3,65,87,0,0,0,0
2023-02-02T07:00,22.4,49,2,38,81,0,0,0,0
2023-02-02T08:00,22.4,46,1,43,65,0,0,0,0
2023-02-02T09:00,22,19,1,18,23,0,0,0,0
2023-02-02T10:00,21.9,15,1,9,28,0,0,0,0
2023-02-02T11:00,21.5,16,1,19,11,0,0,0,0
2023-02-02T12:00,21.4,23,0,38,0,0,0,0,0
2023-02-02T13:00,21.5,31,0,51,0,19,11,8,0
2023-02-02T14:00,23.7,24,0,39,1,150,103,47,403.6
2023-02-02T15:00,26.9,19,0,32,0,276,183,93,571.1
2023-02-02T16:00,30.2,29,0,48,0,397,267,130,584.1
2023-02-02T17:00,32.7,43,0,71,0,500,391,109,708.4
2023-02-02T18:00,35.1,24,0,40,0,505,392,113,794.7
2023-02-02T19:00,36.7,9,0,15,0,424,295,129,686.4
2023-02-02T20:00,37.6,0,0,0,0,399,323,76,708.2
2023-02-02T21:00,37.2,0,0,0,0,266,209,57,792.5
2023-02-02T22:00,34.6,1,0,2,0,105,71,34,633.2
2023-02-02T23:00,31.9,3,0,5,0,3,1,2,39.3
2023-02-03T00:00,30,24,0,40,0,0,0,0,0
2023-02-03T01:00,31.8,51,12,67,0,0,0,0,0
2023-02-03T02:00,30.2,100,88,97,0,0,0,0,0
2023-02-03T03:00,31.9,100,87,99,0,0,0,0,0
2023-02-03T04:00,29.2,100,95,93,0,0,0,0,0
2023-02-03T05:00,26.4,100,97,97,0,0,0,0,0
2023-02-03T06:00,21,100,88,70,0,0,0,0,0
2023-02-03T07:00,22.3,100,94,68,0,0,0,0,0
2023-02-03T08:00,17.8,100,85,87,0,0,0,0,0
2023-02-03T09:00,19.2,100,84,92,0,0,0,0,0
2023-02-03T10:00,13.2,100,94,95,0,0,0,0,0
2023-02-03T11:00,15.5,100,91,87,0,0,0,0,0
2023-02-03T12:00,11.3,100,88,58,0,0,0,0,0
2023-02-03T13:00,12.5,78,74,19,0,14,3,11,0
2023-02-03T14:00,12.6,88,94,5,0,124,60,64,188.6
2023-02-03T15:00,10.4,100,99,39,0,247,123,124,352.7
2023-02-03T16:00,8.3,100,95,62,0,368,206,162,421.5
2023-02-03T17:00,11,82,60,46,0,459,284,175,524.8
2023-02-03T18:00,11.8,93,75,43,0,460,307,153,587.5
2023-02-03T19:00,10.4,87,67,45,0,445,297,148,611.4
2023-02-03T20:00,10.9,100,88,71,0,358,217,141,588.2
2023-02-03T21:00,9.4,100,91,84,0,196,87,109,426
2023-02-03T22:00,9.4,100,77,63,0,76,20,56,217.5
2023-02-03T23:00,9,100,93,74,0,3,0,3,12.2
2023-02-04T00:00,8.4,100,89,67,0,0,0,0,0
2023-02-04T01:00,5.1,100,88,61,0,0,0,0,0
2023-02-04T02:00,3.4,100,91,47,0,0,0,0,0
2023-02-04T03:00,1.8,87,92,7,0,0,0,0,0
2023-02-04T04:00,1.2,93,99,7,0,0,0,0,0
2023-02-04T05:00,0.8,91,99,3,0,0,0,0,0
2023-02-04T06:00,1.5,90,100,0,0,0,0,0,0
2023-02-04T07:00,1.1,90,100,0,0,0,0,0,0
2023-02-04T08:00,0.6,88,98,0,0,0,0,0,0
2023-02-04T09:00,-2.2,90,100,0,0,0,0,0,0
2023-02-04T10:00,-2.1,90,100,0,0,0,0,0,0
2023-02-04T11:00,-2.8,90,100,0,0,0,0,0,0
2023-02-04T12:00,-1.1,90,100,0,0,0,0,0,0
2023-02-04T13:00,-2.8,100,100,14,4,18,6,12,0
2023-02-04T14:00,2.6,91,99,3,0,149,82,67,273.9
2023-02-04T15:00,4.5,100,100,69,0,291,161,130,467.3
2023-02-04T16:00,10.3,100,60,95,0,404,225,179,494.7
2023-02-04T17:00,13.4,58,2,94,0,499,331,168,595.5
2023-02-04T18:00,17.5,56,0,93,0,470,230,240,560.8
2023-02-04T19:00,17.7,54,4,83,3,413,204,209,418.1
2023-02-04T20:00,22.5,42,0,66,7,368,221,147,484.8
2023-02-04T21:00,22.8,27,2,30,23,231,114,117,472.5
2023-02-04T22:00,24.3,33,1,12,82,104,58,46,400.5
2023-02-04T23:00,20.1,22,0,0,73,5,1,4,40.9
2023-02-05T00:00,22.9,17,0,1,54,0,0,0,0
2023-02-05T01:00,20.5,43,0,36,71,0,0,0,0
2023-02-05T02:00,22.6,72,0,77,87,0,0,0,0
2023-02-05T03:00,19.1,32,0,6,96,0,0,0,0
2023-02-05T04:00,22.5,26,1,1,81,0,0,0,0
2023-02-05T05:00,20.6,30,0,6,89,0,0,0,0
2023-02-05T06:00,22.7,29,0,0,98,0,0,0,0
2023-02-05T07:00,19.8,29,0,0,98,0,0,0,0
2023-02-05T08:00,23.1,83,0,88,100,0,0,0,0
2023-02-05T09:00,21.9,50,0,34,100,0,0,0,0
2023-02-05T10:00,24.8,30,0,0,100,0,0,0,0
2023-02-05T11:00,23.8,37,0,12,100,0,0,0,0
2023-02-05T12:00,27.3,81,0,85,100,0,0,0,0
2023-02-05T13:00,27.9,89,0,98,99,13,0,13,0
2023-02-05T14:00,31.8,90,0,100,99,72,0,72,0
2023-02-05T15:00,33.3,68,0,65,96,154,21,133,22.1
2023-02-05T16:00,37.2,31,0,2,99,319,119,200,166
2023-02-05T17:00,39.9,30,0,0,99,406,143,263,283
2023-02-05T18:00,41.9,30,0,0,100,426,162,264,292.3
2023-02-05T19:00,43.5,30,0,0,100,410,203,207,372.4
2023-02-05T20:00,43.3,52,0,36,100,290,69,221,300.7
2023-02-05T21:00,42.3,83,1,89,97,149,21,128,110.4
2023-02-05T22:00,40.5,83,4,92,81,46,8,38,60.9
2023-02-05T23:00,39.3,75,12,99,16,2,0,2,6.1
2023-02-06T00:00,38.6,100,73,99,2,0,0,0,0
2023-02-06T01:00,38.8,100,86,100,1,0,0,0,0
2023-02-06T02:00,38.4,100,92,100,0,0,0,0,0
2023-02-06T03:00,37.9,100,69,100,0,0,0,0,0
2023-02-06T04:00,37.6,100,89,100,0,0,0,0,0
2023-02-06T05:00,37.2,100,96,98,0,0,0,0,0
2023-02-06T06:00,36.7,100,92,91,2,0,0,0,0
2023-02-06T07:00,36.5,100,74,95,53,0,0,0,0
2023-02-06T08:00,36.1,100,95,99,12,0,0,0,0
2023-02-06T09:00,36.2,100,100,98,0,0,0,0,0
2023-02-06T10:00,35.8,87,67,30,29,0,0,0,0
2023-02-06T11:00,35,95,83,25,19,0,0,0,0
2023-02-06T12:00,35,100,95,30,0,0,0,0,0
2023-02-06T13:00,34.8,100,98,55,0,9,0,9,0
2023-02-06T14:00,34.9,93,97,9,0,43,8,35,20.6
2023-02-06T15:00,34.9,91,100,1,0,93,6,87,30.8
2023-02-06T16:00,35.1,88,98,0,0,128,8,120,16.2
2023-02-06T17:00,34.6,87,97,0,0,150,20,130,29.6
2023-02-06T18:00,34.6,77,85,0,0,192,6,186,20.8
2023-02-06T19:00,34,83,92,0,0,276,73,203,74.6
2023-02-06T20:00,33.7,77,86,0,0,247,87,160,182.4
2023-02-06T21:00,33,89,99,0,0,175,67,108,222.1
2023-02-06T22:00,31.4,80,89,0,0,80,22,58,191.8
2023-02-06T23:00,29.9,83,92,0,0,4,0,4,18.2
2023-02-07T00:00,28.3,86,95,0,0,0,0,0,0
2023-02-07T01:00,26.2,88,98,0,0,0,0,0,0
2023-02-07T02:00,25.3,88,98,0,0,0,0,0,0
2023-02-07T03:00,25.2,86,95,0,0,0,0,0,0
2023-02-07T04:00,24.4,85,94,0,0,0,0,0,0
2023-02-07T05:00,24.6,89,99,0,0,0,0,0,0
2023-02-07T06:00,23.9,86,95,0,1,0,0,0,0
2023-02-07T07:00,25.4,84,91,0,7,0,0,0,0
2023-02-07T08:00,25.6,54,58,0,7,0,0,0,0
2023-02-07T09:00,25.6,26,17,0,36,0,0,0,0
2023-02-07T10:00,25.6,3,3,0,0,0,0,0,0
2023-02-07T11:00,25.3,8,0,13,0,0,0,0,0
2023-02-07T12:00,25.9,38,0,21,84,0,0,0,0
2023-02-07T13:00,27.6,33,0,7,97,25,13,12,0
2023-02-07T14:00,31.4,42,0,20,100,154,91,63,350.9
2023-02-07T15:00,35.4,29,0,1,96,268,115,153,392.9
2023-02-07T16:00,38.9,73,0,73,96,396,227,169,416.2
2023-02-07T17:00,41.3,85,0,93,97,425,203,222,466.5
2023-02-07T18:00,42.2,78,0,81,99,345,79,266,272.6
2023-02-07T19:00,41.5,70,10,52,100,220,27,193,91.9
2023-02-07T20:00,41.7,72,22,39,96,176,22,154,46.5
2023-02-07T21:00,41.4,100,49,79,33,118,34,84,83.4
2023-02-07T22:00,40.5,92,36,88,23,55,11,44,97.2
2023-02-07T23:00,39.1,34,14,35,2,2,0,2,9.8
2023-02-08T00:00,38.2,41,26,29,0,0,0,0,0
2023-02-08T01:00,37.9,80,51,57,0,0,0,0,0
2023-02-08T02:00,38.2,79,74,21,0,0,0,0,0
2023-02-08T03:00,37.9,72,79,1,0,0,0,0,0
2023-02-08T04:00,37.8,68,75,0,0,0,0,0,0
2023-02-08T05:00,37.7,75,83,0,0,0,0,0,0
2023-02-08T06:00,37.9,74,82,0,0,0,0,0,0
2023-02-08T07:00,37.6,59,65,0,0,0,0,0,0
2023-02-08T08:00,36.9,75,83,0,0,0,0,0,0
2023-02-08T09:00,36,68,76,0,0,0,0,0,0
2023-02-08T10:00,35.1,61,68,0,0,0,0,0,0
2023-02-08T11:00,34.2,59,65,1,0,0,0,0,0
2023-02-08T12:00,33.9,57,63,0,0,0,0,0,0
2023-02-08T13:00,34,67,74,0,0,15,4,11,0
2023-02-08T14:00,35.2,59,66,0,0,104,43,61,127
2023-02-08T15:00,36.9,48,53,0,0,264,177,87,364.3
2023-02-08T16:00,39.9,67,74,0,0,330,186,144,469.3
2023-02-08T17:00,41.5,77,85,0,0,367,225,142,413.8
2023-02-08T18:00,43.2,63,70,0,0,404,261,143,460.8
2023-02-08T19:00,44.1,12,13,0,0,429,239,190,470.9
2023-02-08T20:00,45,0,0,0,0,411,321,90,610.2
2023-02-08T21:00,45,0,0,0,0,292,233,59,775.1
2023-02-08T22:00,43.9,1,1,0,0,126,88,38,676.5
2023-02-08T23:00,41.9,0,0,0,0,8,4,4,88.5
2023-02-09T00:00,39.4,30,0,0,99,0,0,0,0
2023-02-09T01:00,37.4,18,0,0,61,0,0,0,0
2023-02-09T02:00,37.4,30,0,0,100,0,0,0,0
2023-02-09T03:00,37,30,0,0,100,0,0,0,0
2023-02-09T04:00,36,30,0,0,100,0,0,0,0
2023-02-09T05:00,34.7,30,0,0,100,0,0,0,0
2023-02-09T06:00,33.3,12,0,0,39,0,0,0,0
2023-02-09T07:00,34,0,0,0,0,0,0,0,0
2023-02-09T08:00,34.1,8,0,0,27,0,0,0,0
2023-02-09T09:00,34.1,46,0,26,100,0,0,0,0
2023-02-09T10:00,36,87,0,95,100,0,0,0,0
2023-02-09T11:00,37.8,90,0,100,100,0,0,0,0
2023-02-09T12:00,39.2,100,21,100,100,0,0,0,0
2023-02-09T13:00,38.5,100,73,100,100,4,0,4,0
2023-02-09T14:00,38.3,100,97,100,100,13,0,13,0
2023-02-09T15:00,38.7,100,28,100,100,20,0,20,0
2023-02-09T16:00,39.5,100,49,100,100,33,0,33,0
2023-02-09T17:00,40.9,100,34,100,100,58,0,58,0
2023-02-09T18:00,43,100,36,100,100,106,2,104,2
2023-02-09T19:00,44.6,100,45,98,100,81,0,81,2
2023-02-09T20:00,46.6,100,32,100,92,75,0,75,0
2023-02-09T21:00,47,76,13,66,82,37,0,37,0
2023-02-09T22:00,47.7,42,11,34,38,55,18,37,56.7
2023-02-09T23:00,47.1,16,8,15,0,7,2,5,21.6
2023-02-10T00:00,46.9,27,5,38,0,0,0,0,0
2023-02-10T01:00,48.2,47,5,70,0,0,0,0,0
2023-02-10T02:00,48.6,32,8,41,0,0,0,0,0
2023-02-10T03:00,50.1,30,9,36,0,0,0,0,0
2023-02-10T04:00,50.9,100,81,86,0,0,0,0,0
2023-02-10T05:00,51.7,100,100,98,0,0,0,0,0
2023-02-10T06:00,51.3,100,100,77,0,0,0,0,0
2023-02-10T07:00,49.2,97,93,22,0,0,0,0,0
2023-02-10T08:00,47.4,85,90,7,0,0,0,0,0
2023-02-10T09:00,44.9,100,99,30,0,0,0,0,0
2023-02-10T10:00,43.1,100,99,62,0,0,0,0,0
2023-02-10T11:00,41.6,100,97,89,0,0,0,0,0
2023-02-10T12:00,40.7,100,98,94,0,0,0,0,0
2023-02-10T13:00,40.1,100,92,55,0,7,1,6,0
2023-02-10T14:00,40.2,87,88,13,0,53,14,39,39.1
2023-02-10T15:00,40.7,89,95,5,0,146,37,109,87.1
2023-02-10T16:00,41,93,97,9,0,158,33,125,91.4
2023-02-10T17:00,41.4,97,100,11,0,163,8,155,41
2023-02-10T18:00,41.9,100,100,18,0,181,22,159,24.9
2023-02-10T19:00,41.8,96,99,11,0,167,24,143,45.5
2023-02-10T20:00,41.6,92,100,4,0,124,10,114,34.6
2023-02-10T21:00,41.1,100,98,45,0,90,13,77,32.2
2023-02-10T22:00,40.1,100,87,91,0,34,3,31,31.5
2023-02-10T23:00,39,88,51,70,0,2,0,2,2.8
2023-02-11T00:00,38,53,23,53,0,0,0,0,0
2023-02-11T01:00,36,73,42,59,0,0,0,0,0
2023-02-11T02:00,34.5,29,11,32,0,0,0,0,0
2023-02-11T03:00,33.5,15,13,5,0,0,0,0,0
2023-02-11T04:00,32.8,20,21,1,0,0,0,0,0
2023-02-11T05:00,32.2,26,26,4,0,0,0,0,0
2023-02-11T06:00,31.3,77,82,6,0,0,0,0,0
2023-02-11T07:00,31,87,88,13,0,0,0,0,0
2023-02-11T08:00,30.7,87,79,27,0,0,0,0,0
2023-02-11T09:00,30.6,85,93,2,0,0,0,0,0
2023-02-11T10:00,30.4,82,91,0,0,0,0,0,0
2023-02-11T11:00,30.1,75,83,0,0,0,0,0,0
2023-02-11T12:00,29.7,82,91,0,0,0,0,0,0
2023-02-11T13:00,29.7,89,99,0,0,15,2,13,0
2023-02-11T14:00,30.3,90,100,0,0,87,13,74,48.3
2023-02-11T15:00,30.9,90,100,0,0,122,1,121,29.2
2023-02-11T16:00,32.3,90,100,0,0,209,38,171,37.4
2023-02-11T17:00,33.8,90,100,0,0,299,61,238,97
2023-02-11T18:00,35.5,90,100,0,0,360,109,251,156.2
2023-02-11T19:00,36.5,90,100,0,0,346,110,236,203.4
2023-02-11T20:00,37.8,64,71,0,0,336,145,191,260.2
2023-02-11T21:00,38.3,1,1,0,0,271,184,87,454.3
2023-02-11T22:00,37.2,0,0,0,0,138,97,41,600.2
2023-02-11T23:00,34.5,0,0,0,0,12,7,5,124.1
2023-02-12T00:00,32.9,0,0,0,0,0,0,0,0
2023-02-12T01:00,31.7,0,0,0,0,0,0,0,0
2023-02-12T02:00,31.4,2,0,0,8,0,0,0,0
2023-02-12T03:00,31.1,10,0,0,34,0,0,0,0
2023-02-12T04:00,31.3,24,0,0,81,0,0,0,0
2023-02-12T05:00,31.2,17,0,0,55,0,0,0,0
2023-02-12T06:00,30.6,3,0,0,11,0,0,0,0
2023-02-12T07:00,30.3,28,0,0,92,0,0,0,0
2023-02-12T08:00,29.8,15,0,0,51,0,0,0,0
2023-02-12T09:00,29.4,9,0,0,30,0,0,0,0
2023-02-12T10:00,29.1,11,0,0,37,0,0,0,0
2023-02-12T11:00,28.8,26,0,0,87,0,0,0,0
2023-02-12T12:00,28.4,29,0,0,95,0,0,0,0
2023-02-12T13:00,29.1,30,0,0,100,33,13,20,0
2023-02-12T14:00,34.4,30,0,0,100,177,111,66,341.9
2023-02-12T15:00,39.4,30,0,0,100,335,240,95,581.6
2023-02-12T16:00,42.9,30,0,0,100,462,349,113,697.7
2023-02-12T17:00,45.7,29,0,0,98,546,431,115,769.7
2023-02-12T18:00,47.7,30,0,0,100,571,456,115,816.1
2023-02-12T19:00,48.2,30,0,0,100,520,390,130,784.9
2023-02-12T20:00,48.4,30,0,0,100,433,328,105,743.7
2023-02-12T21:00,46.2,30,0,0,100,289,196,93,681.3
2023-02-12T22:00,43.6,30,0,0,100,121,60,61,483.6
2023-02-12T23:00,39.3,30,0,0,100,11,2,9,76.3
2023-02-13T00:00,36.6,30,0,0,100,0,0,0,0
2023-02-13T01:00,34.7,30,0,0,99,0,0,0,0
2023-02-13T02:00,33.3,29,0,0,97,0,0,0,0
2023-02-13T03:00,32,30,0,0,99,0,0,0,0
2023-02-13T04:00,30.6,29,0,0,97,0,0,0,0
2023-02-13T05:00,29.9,30,0,0,100,0,0,0,0
2023-02-13T06:00,30.3,28,0,0,94,0,0,0,0
2023-02-13T07:00,29.8,26,0,0,86,0,0,0,0
2023-02-13T08:00,29.8,19,0,0,63,0,0,0,0
2023-02-13T09:00,29.4,16,0,0,54,0,0,0,0
2023-02-13T10:00,30.3,1,0,0,4,0,0,0,0
2023-02-13T11:00,31.9,1,0,0,2,0,0,0,0
2023-02-13T12:00,32.4,0,0,0,0,0,0,0,0
2023-02-13T13:00,33.2,0,0,0,0,40,26,14,0
2023-02-13T14:00,38.9,0,0,0,0,199,152,47,524
2023-02-13T15:00,44.3,0,0,0,0,366,303,63,746.3
2023-02-13T16:00,47.7,39,0,65,0,499,430,69,861
2023-02-13T17:00,50.1,53,0,86,3,574,493,81,905.2
2023-02-13T18:00,51.7,45,0,62,26,592,509,83,914.7
2023-02-13T19:00,52.4,34,0,43,26,522,396,126,835.2
2023-02-13T20:00,51.6,30,0,42,17,411,288,123,685.2
2023-02-13T21:00,49.9,31,5,43,1,312,246,66,702.5
2023-02-13T22:00,45.7,35,1,56,0,125,70,55,587.7
2023-02-13T23:00,41.4,8,1,12,0,13,6,7,96.8
2023-02-14T00:00,40,19,12,13,0,0,0,0,0
2023-02-14T01:00,38.7,37,18,35,0,0,0,0,0
2023-02-14T02:00,37.8,52,46,17,0,0,0,0,0
2023-02-14T03:00,37.1,46,51,1,0,0,0,0,0
2023-02-14T04:00,36.3,45,50,0,0,0,0,0,0
2023-02-14T05:00,35.5,54,60,0,0,0,0,0,0
2023-02-14T06:00,35,56,62,0,0,0,0,0,0
2023-02-14T07:00,35.3,41,46,0,0,0,0,0,0
2023-02-14T08:00,34.9,21,23,0,0,0,0,0,0
2023-02-14T09:00,34,12,13,0,0,0,0,0,0
2023-02-14T10:00,33.3,1,1,0,0,0,0,0,0
2023-02-14T11:00,32.8,2,2,0,0,0,0,0,0
2023-02-14T12:00,32.4,0,0,0,0,0,0,0,0
2023-02-14T13:00,32.4,0,0,0,0,43,27,16,0
2023-02-14T14:00,37,0,0,0,0,200,151,49,516.1
2023-02-14T15:00,40.6,0,0,0,0,371,307,64,738.4
2023-02-14T16:00,43.6,0,0,0,0,499,424,75,850.4
2023-02-14T17:00,45.9,0,0,0,0,581,505,76,900.4
2023-02-14T18:00,47.7,0,0,0,0,600,523,77,926
2023-02-14T19:00,49.5,0,0,0,0,558,483,75,918.2
2023-02-14T20:00,50.3,0,0,0,0,463,393,70,888.9
2023-02-14T21:00,50.1,0,0,0,0,321,261,60,829.5
2023-02-14T22:00,48,0,0,0,0,151,110,41,707.6
2023-02-14T23:00,44.1,0,0,0,0,16,9,7,164.2
2023-02-15T00:00,40.5,8,0,0,27,0,0,0,0
2023-02-15T01:00,38.5,30,0,0,100,0,0,0,0
2023-02-15T02:00,38.2,30,0,0,100,0,0,0,0
2023-02-15T03:00,38.5,30,0,0,100,0,0,0,0
2023-02-15T04:00,38.6,32,0,3,100,0,0,0,0
2023-02-15T05:00,39.3,74,0,74,100,0,0,0,0
2023-02-15T06:00,40.5,90,0,100,100,0,0,0,0
2023-02-15T07:00,42.2,90,0,100,100,0,0,0,0
2023-02-15T08:00,43.3,90,0,100,100,0,0,0,0
2023-02-15T09:00,41.9,83,0,100,77,0,0,0,0
2023-02-15T10:00,42.2,87,0,96,97,0,0,0,0
2023-02-15T11:00,43.4,24,0,22,35,0,0,0,0
2023-02-15T12:00,43.7,24,0,39,2,0,0,0,0
2023-02-15T13:00,43.5,25,0,41,0,33,19,14,0
2023-02-15T14:00,45.4,1,0,2,0,139,94,45,326.4
2023-02-15T15:00,48.5,7,0,11,0,285,215,70,487.4
2023-02-15T16:00,51.6,14,5,16,0,367,230,137,514.3
2023-02-15T17:00,55.2,13,9,8,0,509,403,106,585.4
2023-02-15T18:00,58.5,4,4,0,0,596,524,72,838.1
2023-02-15T19:00,61.9,26,2,40,0,523,428,95,873.9
2023-02-15T20:00,63,30,3,46,0,381,285,96,709.5
2023-02-15T21:00,62.5,11,0,18,0,239,172,67,559.2
2023-02-15T22:00,60.6,5,0,8,0,134,89,45,499.7
2023-02-15T23:00,56.5,9,1,14,0,16,9,7,142
2023-02-16T00:00,54.2,10,4,11,0,0,0,0,0
2023-02-16T01:00,52.5,4,2,3,0,0,0,0,0
2023-02-16T02:00,51.1,1,1,0,0,0,0,0,0
2023-02-16T03:00,50.4,3,2,2,0,0,0,0,0
2023-02-16T04:00,47.9,0,0,0,0,0,0,0,0
2023-02-16T05:00,46,0,0,0,0,0,0,0,0
2023-02-16T06:00,44.1,0,0,0,0,0,0,0,0
2023-02-16T07:00,44.7,0,0,0,0,0,0,0,0
2023-02-16T08:00,43,0,0,0,0,0,0,0,0
2023-02-16T09:00,41.6,0,0,0,0,0,0,0,0
2023-02-16T10:00,39.6,1,1,0,1,0,0,0,0
2023-02-16T11:00,37.9,17,0,0,58,0,0,0,0
2023-02-16T12:00,37,26,0,0,85,0,0,0,0
2023-02-16T13:00,38.4,30,4,0,88,36,11,25,0
2023-02-16T14:00,41.9,35,5,0,100,141,65,76,210.8
2023-02-16T15:00,44.5,32,2,0,100,215,92,123,267.8
2023-02-16T16:00,45,55,1,40,100,197,7,190,127.3
2023-02-16T17:00,45.9,64,0,56,100,230,3,227,2.3
2023-02-16T18:00,47.4,89,1,97,100,236,3,233,3.7
2023-02-16T19:00,48.9,93,4,99,100,248,20,228,22.3
2023-02-16T20:00,48.6,97,8,100,100,163,0,163,19.7
2023-02-16T21:00,47.7,97,14,91,100,120,3,117,2.6
2023-02-16T22:00,46.9,62,11,36,100,71,3,68,13.7
2023-02-16T23:00,45,86,5,86,100,9,0,9,4.5
2023-02-17T00:00,44.4,86,1,91,100,0,0,0,0
2023-02-17T01:00,45,83,9,75,100,0,0,0,0
2023-02-17T02:00,45.6,100,72,84,100,0,0,0,0
2023-02-17T03:00,47.1,100,100,98,100,0,0,0,0
2023-02-17T04:00,48.6,100,92,53,100,0,0,0,0
2023-02-17T05:00,49.7,99,77,0,99,0,0,0,0
2023-02-17T06:00,49.8,87,61,3,100,0,0,0,0
2023-02-17T07:00,50.3,93,70,0,100,0,0,0,0
2023-02-17T08:00,51,100,76,8,100,0,0,0,0
2023-02-17T09:00,52.1,100,93,9,100,0,0,0,0
2023-02-17T10:00,53.1,100,97,29,100,0,0,0,0
2023-02-17T11:00,54.2,100,92,90,100,0,0,0,0
2023-02-17T12:00,52.6,100,100,100,100,0,0,0,0
2023-02-17T13:00,48,100,99,100,100,4,0,4,0
2023-02-17T14:00,43.1,100,100,98,100,21,0,21,0
2023-02-17T15:00,38.8,100,99,83,54,47,0,47,0
2023-02-17T16:00,32.8,100,100,34,0,93,3,90,3
2023-02-17T17:00,31.4,100,100,25,0,135,2,133,3.4
2023-02-17T18:00,31.5,91,100,2,0,235,25,210,22.2
2023-02-17T19:00,31.5,91,100,1,0,244,32,212,53.9
2023-02-17T20:00,30.2,92,100,3,0,154,9,145,39.8
2023-02-17T21:00,29,90,100,0,0,124,7,117,18.1
2023-02-17T22:00,28.1,90,100,0,0,61,5,56,23.8
2023-02-17T23:00,27.5,90,100,0,0,7,0,7,7.8
2023-02-18T00:00,27.2,94,100,6,0,0,0,0,0
2023-02-18T01:00,27.3,97,100,12,0,0,0,0,0
2023-02-18T02:00,27,84,91,3,0,0,0,0,0
2023-02-18T03:00,26.7,79,88,0,0,0,0,0,0
2023-02-18T04:00,26.2,88,98,0,0,0,0,0,0
2023-02-18T05:00,25.9,79,88,0,0,0,0,0,0
2023-02-18T06:00,25.5,89,99,0,0,0,0,0,0
2023-02-18T07:00,25.1,88,98,0,0,0,0,0,0
2023-02-18T08:00,25,90,100,0,0,0,0,0,0
2023-02-18T09:00,24.7,63,70,0,0,0,0,0,0
2023-02-18T10:00,24.3,73,81,0,0,0,0,0,0
2023-02-18T11:00,24.1,78,87,0,0,0,0,0,0
2023-02-18T12:00,24,41,45,0,0,0,0,0,0
2023-02-18T13:00,25,46,51,0,0,54,35,19,0
2023-02-18T14:00,27.4,7,8,0,0,220,160,60,526.5
2023-02-18T15:00,30.5,0,0,0,0,384,302,82,701.5
2023-02-18T16:00,34.1,2,1,0,3,527,447,80,829.3
2023-02-18T17:00,37.5,7,0,0,23,604,504,100,895.6
2023-02-18T18:00,40.2,14,0,1,45,604,470,134,842.9
2023-02-18T19:00,42.3,3,0,0,11,585,484,101,835.6
2023-02-18T20:00,43.5,0,0,0,0,496,418,78,885.7
2023-02-18T21:00,43.5,0,0,0,0,351,288,63,858.4
2023-02-18T22:00,40.7,0,0,0,0,174,129,45,747.6
2023-02-18T23:00,37.4,0,0,0,0,23,14,9,225.5
2023-02-19T00:00,35.2,3,0,0,9,0,0,0,0
2023-02-19T01:00,33.7,17,0,0,57,0,0,0,0
2023-02-19T02:00,32.6,20,0,0,66,0,0,0,0
2023-02-19T03:00,32,31,1,0,99,0,0,0,0
2023-02-19T04:00,31.5,35,5,0,100,0,0,0,0
2023-02-19T05:00,31,29,3,0,89,0,0,0,0
2023-02-19T06:00,30.8,32,2,0,100,0,0,0,0
2023-02-19T07:00,30.7,30,0,0,100,0,0,0,0
2023-02-19T08:00,30.9,30,0,0,100,0,0,0,0
2023-02-19T09:00,30.9,30,0,0,100,0,0,0,0
2023-02-19T10:00,31.1,30,0,0,100,0,0,0,0
2023-02-19T11:00,31.1,61,0,52,100,0,0,0,0
2023-02-19T12:00,31.5,86,0,94,100,0,0,0,0
2023-02-19T13:00,32.9,87,0,95,100,29,1,28,0
2023-02-19T14:00,35.7,90,0,100,100,106,3,103,10.5
2023-02-19T15:00,38.6,90,0,100,100,183,15,168,25.4
2023-02-19T16:00,40.8,89,0,99,100,211,6,205,24.7
2023-02-19T17:00,43.7,90,0,100,100,291,22,269,24.3
2023-02-19T18:00,44.9,90,0,100,100,278,16,262,31.8
2023-02-19T19:00,46.2,85,0,93,97,287,44,243,52.5
2023-02-19T20:00,45.8,78,0,83,93,210,33,177,75
2023-02-19T21:00,45.7,31,0,5,92,167,36,131,78.7
2023-02-19T22:00,44.4,38,0,25,76,122,47,75,173.1
2023-02-19T23:00,43,24,0,25,30,14,4,10,86.5
2023-02-20T00:00,41.4,22,1,23,23,0,0,0,0
2023-02-20T01:00,40.5,19,3,10,33,0,0,0,0
2023-02-20T02:00,39,29,1,12,68,0,0,0,0
2023-02-20T03:00,38.4,28,0,3,88,0,0,0,0
2023-02-20T04:00,37.8,25,0,1,82,0,0,0,0
2023-02-20T05:00,37.3,22,0,0,74,0,0,0,0
2023-02-20T06:00,36.9,28,0,0,94,0,0,0,0
2023-02-20T07:00,37.1,67,0,62,98,0,0,0,0
2023-02-20T08:00,37.6,84,5,83,99,0,0,0,0
2023-02-20T09:00,37.8,100,19,94,99,0,0,0,0
2023-02-20T10:00,38.4,90,4,95,99,0,0,0,0
2023-02-20T11:00,38.7,88,6,89,98,0,0,0,0
2023-02-20T12:00,39,54,5,39,88,0,0,0,0
2023-02-20T13:00,40.2,54,10,51,48,22,3,19,0
2023-02-20T14:00,41.6,61,22,68,0,92,25,67,58.3
2023-02-20T15:00,44.7,85,30,97,0,228,93,135,159.8
2023-02-20T16:00,45.9,93,55,73,0,333,167,166,283.7
2023-02-20T17:00,46.4,55,46,23,0,349,161,188,293.4
2023-02-20T18:00,47.7,46,36,23,0,474,344,130,421.1
2023-02-20T19:00,48.1,46,45,5,8,492,363,129,627.2
2023-02-20T20:00,47.5,81,46,44,43,396,273,123,606.3
2023-02-20T21:00,46.3,89,39,58,63,317,231,86,608.4
2023-02-20T22:00,43.2,66,42,11,72,153,85,68,538.2
2023-02-20T23:00,39.3,50,7,23,100,24,11,13,155.9
2023-02-21T00:00,37,61,0,51,100,0,0,0,0
2023-02-21T01:00,35,80,0,85,95,0,0,0,0
2023-02-21T02:00,34,78,0,94,73,0,0,0,0
2023-02-21T03:00,33.2,71,1,93,49,0,0,0,0
2023-02-21T04:00,32.9,82,1,91,87,0,0,0,0
2023-02-21T05:00,33.9,76,0,94,64,0,0,0,0
2023-02-21T06:00,33,60,1,98,0,0,0,0,0
2023-02-21T07:00,33.9,55,0,91,0,0,0,0,0
2023-02-21T08:00,32.3,14,1,21,1,0,0,0,0
2023-02-21T09:00,31.1,0,0,0,0,0,0,0,0
2023-02-21T10:00,31.1,0,0,0,0,0,0,0,0
2023-02-21T11:00,31.2,21,0,3,65,0,0,0,0
2023-02-21T12:00,31.4,47,0,34,90,0,0,0,0
2023-02-21T13:00,33.3,82,0,89,94,60,32,28,0
2023-02-21T14:00,37.2,88,0,97,100,192,88,104,334.7
2023-02-21T15:00,41.2,88,2,99,88,304,120,184,308.3
2023-02-21T16:00,44.9,86,1,98,86,410,188,222,330.6
2023-02-21T17:00,46.8,100,59,98,87,384,132,252,305.5
2023-02-21T18:00,45.4,83,26,74,49,254,30,224,126.1
2023-02-21T19:00,44.2,47,15,48,17,312,134,178,129.1
2023-02-21T20:00,42.3,27,16,21,0,331,176,155,295.2
2023-02-21T21:00,43.2,33,25,17,0,313,222,91,490.8
2023-02-21T22:00,41.4,50,29,39,0,168,111,57,586.8
2023-02-21T23:00,38.1,3,3,1,0,27,15,12,214.7
2023-02-22T00:00,36,0,0,0,0,0,0,0,0
2023-02-22T01:00,35.2,39,43,0,0,0,0,0,0
2023-02-22T02:00,34.9,71,79,0,0,0,0,0,0
2023-02-22T03:00,34.4,64,70,1,0,0,0,0,0
2023-02-22T04:00,34.3,72,50,10,70,0,0,0,0
2023-02-22T05:00,34,71,29,59,30,0,0,0,0
2023-02-22T06:00,33.3,43,18,0,89,0,0,0,0
2023-02-22T07:00,32.6,33,22,0,44,0,0,0,0
2023-02-22T08:00,32,81,24,62,74,0,0,0,0
2023-02-22T09:00,31.5,59,31,30,43,0,0,0,0
2023-02-22T10:00,31,62,58,3,26,0,0,0,0
2023-02-22T11:00,30.6,94,57,60,21,0,0,0,0
2023-02-22T12:00,29.9,100,55,87,63,0,0,0,0
2023-02-22T13:00,31.6,100,65,86,91,56,26,30,0
2023-02-22T14:00,33.4,100,84,98,97,170,75,95,278.9
2023-02-22T15:00,33.8,100,93,100,100,81,5,76,147.6
2023-02-22T16:00,34.2,100,85,100,100,91,0,91,0.7
2023-02-22T17:00,35,100,80,99,100,128,0,128,0
2023-02-22T18:00,36,100,79,100,100,186,9,177,7.9
2023-02-22T19:00,36.3,100,68,99,100,143,0,143,7.9
2023-02-22T20:00,36,100,96,100,100,121,3,118,2.7
2023-02-22T21:00,35,100,87,100,100,49,0,49,3.3
2023-02-22T22:00,34,100,90,100,100,23,0,23,0
2023-02-22T23:00,33.4,100,82,100,100,3,0,3,0
2023-02-23T00:00,33.4,100,92,99,100,0,0,0,0
2023-02-23T01:00,32.7,100,92,100,99,0,0,0,0
2023-02-23T02:00,32.9,100,100,100,100,0,0,0,0
2023-02-23T03:00,33.2,100,100,95,100,0,0,0,0
2023-02-23T04:00,33.6,100,94,100,100,0,0,0,0
2023-02-23T05:00,34.1,100,94,98,0,0,0,0,0
2023-02-23T06:00,34.7,100,89,99,22,0,0,0,0
2023-02-23T07:00,35,100,98,100,0,0,0,0,0
2023-02-23T08:00,35.6,100,100,100,0,0,0,0,0
2023-02-23T09:00,36.2,100,100,100,0,0,0,0,0
2023-02-23T10:00,36.9,100,100,100,0,0,0,0,0
2023-02-23T11:00,37.5,100,100,100,0,0,0,0,0
2023-02-23T12:00,37.7,100,100,32,0,0,0,0,0
2023-02-23T13:00,37.8,99,100,15,0,8,1,7,0
2023-02-23T14:00,38.4,98,100,13,0,53,3,50,10.2
2023-02-23T15:00,37.1,100,100,65,0,95,4,91,9.1
2023-02-23T16:00,36.4,100,100,91,0,162,21,141,23.2
2023-02-23T17:00,36.9,100,100,47,0,245,39,206,53.6
2023-02-23T18:00,38.6,93,100,5,0,307,41,266,63.7
2023-02-23T19:00,40.5,100,100,22,0,356,92,264,111.8
2023-02-23T20:00,42.5,100,96,71,0,286,88,198,175.9
2023-02-23T21:00,43.4,86,66,45,0,152,31,121,128.3
2023-02-23T22:00,42.7,64,34,55,0,99,35,64,120
2023-02-23T23:00,42.5,100,72,70,0,8,4,4,71.3
2023-02-24T00:00,43.6,100,100,100,0,0,0,0,0
2023-02-24T01:00,42,100,99,61,0,0,0,0,0
2023-02-24T02:00,41.5,100,92,38,0,0,0,0,0
2023-02-24T03:00,40.9,93,79,37,0,0,0,0,0
2023-02-24T04:00,41.4,80,86,5,0,0,0,0,0
2023-02-24T05:00,41.3,82,91,0,0,0,0,0,0
2023-02-24T06:00,40,89,98,1,0,0,0,0,0
2023-02-24T07:00,36,91,96,8,0,0,0,0,0
2023-02-24T08:00,35.1,94,84,30,0,0,0,0,0
2023-02-24T09:00,34.4,100,86,71,0,0,0,0,0
2023-02-24T10:00,32.3,100,70,74,0,0,0,0,0
2023-02-24T11:00,28.7,65,52,30,0,0,0,0,0
2023-02-24T12:00,25.3,41,36,14,0,0,0,0,0
2023-02-24T13:00,23.6,100,85,59,0,28,3,25,0
2023-02-24T14:00,23.3,100,88,40,0,91,6,85,18.9
2023-02-24T15:00,23.4,81,81,14,0,203,67,136,85.3
2023-02-24T16:00,24.1,69,72,7,0,296,118,178,200.4
2023-02-24T17:00,24.5,73,81,0,0,297,44,253,149.2
2023-02-24T18:00,25.3,87,97,0,0,356,71,285,90
2023-02-24T19:00,26.1,85,94,0,0,301,38,263,90.4
2023-02-24T20:00,25.2,89,99,0,0,244,60,184,91.6
2023-02-24T21:00,24.3,89,99,0,0,179,31,148,105
2023-02-24T22:00,23.3,90,100,0,0,95,9,86,59.3
2023-02-24T23:00,22.4,90,100,0,0,18,3,15,20.8
2023-02-25T00:00,21.8,88,98,0,0,0,0,0,0
2023-02-25T01:00,21,73,81,0,0,0,0,0,0
2023-02-25T02:00,20.5,69,77,0,0,0,0,0,0
2023-02-25T03:00,20,70,78,0,0,0,0,0,0
2023-02-25T04:00,19.7,74,82,0,0,0,0,0,0
2023-02-25T05:00,18.9,68,76,0,0,0,0,0,0
2023-02-25T06:00,18.1,65,72,0,0,0,0,0,0
2023-02-25T07:00,18.5,100,80,80,8,0,0,0,0
2023-02-25T08:00,18,100,87,98,47,0,0,0,0
2023-02-25T09:00,18,100,94,100,25,0,0,0,0
2023-02-25T10:00,18.1,100,86,100,92,0,0,0,0
2023-02-25T11:00,18.3,100,97,100,95,0,0,0,0
2023-02-25T12:00,18.8,100,84,100,91,0,0,0,0
2023-02-25T13:00,19.8,100,64,100,77,34,1,33,0
2023-02-25T14:00,21.2,100,98,100,91,94,5,89,13.2
2023-02-25T15:00,23.1,100,97,100,93,143,5,138,14.4
2023-02-25T16:00,25.2,100,56,100,85,220,14,206,17.7
2023-02-25T17:00,28,100,67,100,93,273,26,247,34.6
2023-02-25T18:00,31.5,100,80,94,48,321,32,289,40.8
2023-02-25T19:00,34.5,100,75,91,6,376,132,244,136.3
2023-02-25T20:00,37.1,100,95,100,0,315,126,189,253.3
2023-02-25T21:00,36.2,100,100,100,0,100,9,91,139.1
2023-02-25T22:00,34,100,99,100,0,60,5,55,14.3
2023-02-25T23:00,31.4,100,94,96,0,10,0,10,8.7
2023-02-26T00:00,29.6,100,99,83,0,0,0,0,0
2023-02-26T01:00,28.9,98,88,31,0,0,0,0,0
2023-02-26T02:00,27.9,83,86,9,0,0,0,0,0
2023-02-26T03:00,27.4,83,90,4,0,0,0,0,0
2023-02-26T04:00,27.4,65,72,0,0,0,0,0,0
2023-02-26T05:00,24.9,24,27,0,0,0,0,0,0
2023-02-26T06:00,24.6,23,26,0,0,0,0,0,0
2023-02-26T07:00,25.8,29,8,0,74,0,0,0,0
2023-02-26T08:00,26,41,28,7,39,0,0,0,0
2023-02-26T09:00,26.1,100,64,78,69,0,0,0,0
2023-02-26T10:00,27.3,54,55,7,0,0,0,0,0
2023-02-26T11:00,28.2,39,32,4,27,0,0,0,0
2023-02-26T12:00,28.3,40,44,0,0,1,0,1,0
2023-02-26T13:00,30.8,76,50,14,76,77,43,34,0
2023-02-26T14:00,35.2,56,42,28,5,217,120,97,389
2023-02-26T15:00,38.6,65,69,0,11,293,132,161,355.5
2023-02-26T16:00,41,65,65,0,20,440,221,219,341.4
2023-02-26T17:00,43,65,46,8,61,547,352,195,488.7
2023-02-26T18:00,43.9,76,32,49,60,608,445,163,658
2023-02-26T19:00,44.2,44,35,21,1,523,319,204,634.3
2023-02-26T20:00,43.3,58,46,28,0,431,254,177,510.3
2023-02-26T21:00,41.8,51,47,14,0,323,204,119,513.5
2023-02-26T22:00,39.2,66,48,38,0,161,100,61,485
2023-02-26T23:00,36.1,42,37,14,0,35,20,15,222.5
2023-02-27T00:00,34.1,35,29,13,3,0,0,0,0
2023-02-27T01:00,32.6,24,21,6,4,0,0,0,0
2023-02-27T02:00,31.3,19,17,3,7,0,0,0,0
2023-02-27T03:00,30.3,35,38,1,0,0,0,0,0
2023-02-27T04:00,29.4,47,52,1,0,0,0,0,0
2023-02-27T05:00,28.3,62,69,0,0,0,0,0,0
2023-02-27T06:00,27.9,59,65,0,0,0,0,0,0
2023-02-27T07:00,27.9,47,52,0,0,0,0,0,0
2023-02-27T08:00,27.8,45,50,0,0,0,0,0,0
2023-02-27T09:00,27,50,55,0,0,0,0,0,0
2023-02-27T10:00,26.7,54,34,0,79,0,0,0,0
2023-02-27T11:00,26,68,42,0,99,0,0,0,0
2023-02-27T12:00,25.4,41,29,0,49,1,0,1,0
2023-02-27T13:00,26.1,74,49,0,100,80,44,36,167.2
2023-02-27T14:00,28.5,95,72,0,100,235,129,106,399.4
2023-02-27T15:00,31.3,57,31,0,97,409,271,138,523.2
2023-02-27T16:00,34.4,30,0,0,100,541,368,173,651.1
2023-02-27T17:00,37.3,30,0,0,100,594,363,231,632.4
2023-02-27T18:00,39.9,30,0,0,100,612,375,237,604.3
2023-02-27T19:00,41.9,45,0,25,100,455,144,311,426.6
2023-02-27T20:00,42.3,89,0,99,100,322,61,261,170
2023-02-27T21:00,41.4,90,0,100,100,185,11,174,69.7
2023-02-27T22:00,39.8,90,0,100,100,68,1,67,12.2
2023-02-27T23:00,37,90,0,100,100,8,1,7,4.5
2023-02-28T00:00,34.8,100,12,100,98,0,0,0,0
2023-02-28T01:00,33.7,100,11,100,99,0,0,0,0
2023-02-28T02:00,33.3,100,20,99,100,0,0,0,0
2023-02-28T03:00,32.7,100,55,95,100,0,0,0,0
2023-02-28T04:00,32.1,100,77,100,100,0,0,0,0
2023-02-28T05:00,31.5,100,89,99,92,0,0,0,0
2023-02-28T06:00,31.7,100,90,100,4,0,0,0,0
2023-02-28T07:00,31.5,100,96,100,0,0,0,0,0
2023-02-28T08:00,31.7,100,95,100,0,0,0,0,0
2023-02-28T09:00,32.2,100,92,100,0,0,0,0,0
2023-02-28T10:00,32.4,100,86,98,0,0,0,0,0
2023-02-28T11:00,32.5,100,96,100,0,0,0,0,0
2023-02-28T12:00,32.5,100,92,98,0,0,0,0,0
2023-02-28T13:00,32.7,100,98,99,0,10,0,10,0
2023-02-28T14:00,33.2,100,100,100,0,38,4,34,6.9
2023-02-28T15:00,34.2,100,100,100,0,69,1,68,8.1
2023-02-28T16:00,35.9,100,92,90,0,106,4,102,3.6
2023-02-28T17:00,37.7,100,92,51,0,138,12,126,12.9
2023-02-28T18:00,38.8,85,90,7,0,216,19,197,25.1
2023-02-28T19:00,38.4,88,98,0,0,219,17,202,28.6
2023-02-28T20:00,38.1,90,100,0,0,263,27,236,39.8
2023-02-28T21:00,37.9,86,95,0,0,199,21,178,54.3
2023-02-28T22:00,37.5,67,74,0,0,98,7,91,38.9
2023-02-28T23:00,36,68,76,0,0,26,6,20,26.3
2023-03-01T00:00,35,53,59,0,0,0,0,0,0
2023-03-01T01:00,33.5,55,61,0,0,0,0,0,0
2023-03-01T02:00,32.2,45,50,0,0,0,0,0,0
2023-03-01T03:00,30.9,43,48,0,0,0,0,0,0
2023-03-01T04:00,29.8,43,48,0,0,0,0,0,0
2023-03-01T05:00,28.5,37,41,0,0,0,0,0,0
2023-03-01T06:00,27.1,100,37,76,99,0,0,0,0
2023-03-01T07:00,29.6,100,19,92,100,0,0,0,0
2023-03-01T08:00,29.7,100,16,99,98,0,0,0,0
2023-03-01T09:00,29.5,98,12,99,92,0,0,0,0
2023-03-01T10:00,29.2,89,9,95,80,0,0,0,0
2023-03-01T11:00,28,65,1,94,25,0,0,0,0
2023-03-01T12:00,27.4,72,0,75,91,2,0,2,0
2023-03-01T13:00,28.8,88,0,97,99,75,18,57,64
2023-03-01T14:00,32.1,90,0,100,99,193,48,145,155.6
2023-03-01T15:00,35.2,89,1,100,95,234,9,225,90.6
2023-03-01T16:00,37.9,89,0,100,98,232,4,228,7.4
2023-03-01T17:00,38.2,83,1,95,85,199,13,186,12.5
2023-03-01T18:00,36.9,51,2,78,8,175,25,150,22.2
2023-03-01T19:00,40.9,68,19,73,24,283,144,139,133.1
2023-03-01T20:00,42.9,56,40,19,27,348,181,167,293.9
2023-03-01T21:00,44.1,100,72,64,21,294,184,110,422.6
2023-03-01T22:00,43,60,48,28,0,92,11,81,252.1
2023-03-01T23:00,41.1,11,11,2,0,32,16,16,48.4
2023-03-02T00:00,39.6,11,11,1,0,0,0,0,0
2023-03-02T01:00,38.8,5,5,0,0,0,0,0,0
2023-03-02T02:00,38.1,4,4,0,0,0,0,0,0
2023-03-02T03:00,37.7,40,0,67,0,0,0,0,0
2023-03-02T04:00,37.6,41,0,65,8,0,0,0,0
2023-03-02T05:00,37.8,44,1,31,81,0,0,0,0
2023-03-02T06:00,37.8,47,4,26,94,0,0,0,0
2023-03-02T07:00,36.8,59,5,45,93,0,0,0,0
2023-03-02T08:00,37,68,11,46,100,0,0,0,0
2023-03-02T09:00,37.2,100,55,87,92,0,0,0,0
2023-03-02T10:00,37.6,100,70,92,99,0,0,0,0
2023-03-02T11:00,37.5,100,60,63,58,0,0,0,0
2023-03-02T12:00,37.4,58,57,10,1,1,0,1,0
2023-03-02T13:00,38,64,71,0,0,61,17,44,59.5
2023-03-02T14:00,37,81,90,0,0,144,36,108,121.4
2023-03-02T15:00,37.1,90,100,0,0,239,70,169,136.6
2023-03-02T16:00,37.9,90,100,0,0,264,43,221,117.5
2023-03-02T17:00,38.9,90,100,0,0,288,33,255,61.5
2023-03-02T18:00,39.9,90,100,0,0,294,29,265,47.7
2023-03-02T19:00,39.5,90,100,0,0,300,28,272,43.1
2023-03-02T20:00,39.8,99,100,15,0,254,48,206,68.5
2023-03-02T21:00,39.3,100,98,80,0,158,31,127,86.6
2023-03-02T22:00,37.9,100,97,94,0,69,13,56,63.3
2023-03-02T23:00,36.4,100,94,68,0,19,5,14,36.5
2023-03-03T00:00,35.3,95,88,27,0,0,0,0,0
2023-03-03T01:00,35,77,79,9,0,0,0,0,0
2023-03-03T02:00,34.3,64,71,0,0,0,0,0,0
2023-03-03T03:00,33.6,55,61,0,0,0,0,0,0
2023-03-03T04:00,33.2,75,57,0,80,0,0,0,0
2023-03-03T05:00,32.9,73,60,0,62,0,0,0,0
2023-03-03T06:00,32.3,64,62,4,20,0,0,0,0
2023-03-03T07:00,32.4,51,39,0,52,0,0,0,0
2023-03-03T08:00,31.9,44,37,0,37,0,0,0,0
2023-03-03T09:00,31.5,55,30,0,93,0,0,0,0
2023-03-03T10:00,31.2,50,22,0,100,0,0,0,0
2023-03-03T11:00,30.9,44,16,0,100,0,0,0,0
2023-03-03T12:00,30.8,36,11,0,86,2,0,2,0
2023-03-03T13:00,31.4,37,8,0,100,65,11,54,36.4
2023-03-03T14:00,32.7,33,3,0,100,176,27,149,79
2023-03-03T15:00,34.8,32,2,0,100,315,85,230,133.6
2023-03-03T16:00,36.9,31,1,0,100,408,107,301,188
2023-03-03T17:00,38.7,30,0,0,100,480,141,339,206.1
2023-03-03T18:00,40.3,43,0,21,100,462,118,344,207.4
2023-03-03T19:00,41.2,62,0,53,100,341,52,289,134.7
2023-03-03T20:00,41.4,89,0,99,100,232,12,220,50.5
2023-03-03T21:00,41.3,90,0,100,100,162,4,158,14
2023-03-03T22:00,39.8,90,0,100,100,55,0,55,4.3
2023-03-03T23:00,37.8,89,0,99,100,10,0,10,0
2023-03-04T00:00,36,93,3,100,100,0,0,0,0
2023-03-04T01:00,34.8,100,20,100,100,0,0,0,0
2023-03-04T02:00,34.3,100,69,97,94,0,0,0,0
2023-03-04T03:00,33.8,100,94,100,55,0,0,0,0
2023-03-04T04:00,33.7,100,89,100,40,0,0,0,0
2023-03-04T05:00,34.5,100,83,92,44,0,0,0,0
2023-03-04T06:00,35.5,100,97,99,95,0,0,0,0
2023-03-04T07:00,35.8,100,94,100,100,0,0,0,0
2023-03-04T08:00,36.2,100,91,100,100,0,0,0,0
2023-03-04T09:00,36.4,100,92,100,97,0,0,0,0
2023-03-04T10:00,36.2,100,93,99,64,0,0,0,0
2023-03-04T11:00,35.8,100,98,100,9,0,0,0,0
2023-03-04T12:00,35.3,100,100,100,5,1,0,1,0
2023-03-04T13:00,35.4,100,97,100,25,20,0,20,0
2023-03-04T14:00,35.9,100,99,99,70,54,0,54,0
2023-03-04T15:00,36.9,100,100,100,79,143,5,138,5.3
2023-03-04T16:00,37.8,100,99,99,27,176,5,171,10
2023-03-04T17:00,37,100,100,60,1,178,7,171,8.1
2023-03-04T18:00,36.9,95,99,10,0,285,33,252,29.9
2023-03-04T19:00,35.8,89,99,0,0,266,37,229,58.3
2023-03-04T20:00,35.7,90,100,0,0,205,10,195,39.4
2023-03-04T21:00,35.3,90,100,0,0,129,12,117,22.2
2023-03-04T22:00,34.8,83,92,0,0,79,5,74,19.8
2023-03-04T23:00,34,85,94,0,0,28,11,17,40.4
2023-03-05T00:00,33.6,74,82,0,0,0,0,0,0
2023-03-05T01:00,34.3,77,86,0,0,0,0,0,0
2023-03-05T02:00,34.4,67,74,0,0,0,0,0,0
2023-03-05T03:00,34.2,61,65,0,9,0,0,0,0
2023-03-05T04:00,33.9,77,64,0,63,0,0,0,0
2023-03-05T05:00,33.6,100,57,52,90,0,0,0,0
2023-03-05T06:00,33.4,100,54,98,97,0,0,0,0
2023-03-05T07:00,34.1,100,41,98,91,0,0,0,0
2023-03-05T08:00,34,100,28,100,99,0,0,0,0
2023-03-05T09:00,33.9,96,25,100,45,0,0,0,0
2023-03-05T10:00,33.8,71,17,93,0,0,0,0,0
2023-03-05T11:00,33.3,60,15,77,0,0,0,0,0
2023-03-05T12:00,33.3,58,20,66,0,3,0,3,0
2023-03-05T13:00,35.3,93,69,51,0,93,45,48,142.1
2023-03-05T14:00,37.3,79,82,9,0,205,86,119,293.4
2023-03-05T15:00,40,100,96,29,0,230,45,185,180.8
2023-03-05T16:00,40.9,100,98,37,0,230,22,208,59.9
2023-03-05T17:00,41.6,100,88,36,0,237,25,212,33.8
2023-03-05T18:00,42.3,84,81,18,0,275,58,217,54.9
2023-03-05T19:00,42.5,73,77,6,0,345,175,170,182.5
2023-03-05T20:00,42.3,50,55,1,0,369,175,194,307.9
2023-03-05T21:00,41.5,62,68,2,0,272,143,129,331.7
2023-03-05T22:00,40.3,67,45,44,0,177,100,77,364
2023-03-05T23:00,38,53,38,31,0,49,28,21,263.8
2023-03-06T00:00,37,29,28,6,0,0,0,0,0
2023-03-06T01:00,36.7,12,13,0,0,0,0,0,0
2023-03-06T02:00,36,10,11,0,0,0,0,0,0
2023-03-06T03:00,35.3,5,6,0,0,0,0,0,0
2023-03-06T04:00,34.6,7,8,0,0,0,0,0,0
2023-03-06T05:00,33.9,3,3,0,0,0,0,0,0
2023-03-06T06:00,33.3,4,4,0,0,0,0,0,0
2023-03-06T07:00,33.3,4,4,0,0,0,0,0,0
2023-03-06T08:00,32.6,1,1,0,1,0,0,0,0
2023-03-06T09:00,32,12,6,1,19,0,0,0,0
2023-03-06T10:00,31.6,4,4,0,0,0,0,0,0
2023-03-06T11:00,31.4,0,0,0,0,0,0,0,0
2023-03-06T12:00,31.5,62,3,58,82,4,0,4,0
2023-03-06T13:00,32.4,92,4,97,100,74,1,73,0.2
2023-03-06T14:00,34.1,96,7,99,100,191,51,140,82.9
2023-03-06T15:00,35.4,100,25,100,100,244,22,222,105.6
2023-03-06T16:00,36.8,100,19,100,91,318,35,283,47.4
2023-03-06T17:00,38.2,98,21,95,75,382,51,331,60.5
2023-03-06T18:00,39.6,47,8,66,0,502,194,308,172
2023-03-06T19:00,40,32,3,48,0,554,365,189,431.2
2023-03-06T20:00,40.5,5,0,0,17,562,457,105,717.8
2023-03-06T21:00,40.2,48,0,30,100,422,343,79,855.6
2023-03-06T22:00,38.5,74,0,73,100,185,74,111,559
2023-03-06T23:00,36.2,90,0,100,100,34,1,33,113.9
2023-03-07T00:00,35.1,90,0,100,100,0,0,0,0
2023-03-07T01:00,34,90,0,100,100,0,0,0,0
2023-03-07T02:00,33.5,90,0,100,100,0,0,0,0
2023-03-07T03:00,33.1,90,0,100,100,0,0,0,0
2023-03-07T04:00,32.6,90,0,100,100,0,0,0,0
2023-03-07T05:00,32.4,90,0,100,100,0,0,0,0
2023-03-07T06:00,32.1,80,0,99,70,0,0,0,0
2023-03-07T07:00,32.7,66,0,96,29,0,0,0,0
2023-03-07T08:00,32.1,61,2,96,6,0,0,0,0
2023-03-07T09:00,31.7,46,4,68,6,0,0,0,0
2023-03-07T10:00,30.6,58,6,59,57,0,0,0,0
2023-03-07T11:00,29.1,48,2,47,61,0,0,0,0
2023-03-07T12:00,28,22,3,7,51,6,2,4,0
2023-03-07T13:00,28,48,53,0,1,83,36,47,150.1
2023-03-07T14:00,28.2,76,84,0,0,127,3,124,119.8
2023-03-07T15:00,28.2,82,89,0,5,155,4,151,1.9
2023-03-07T16:00,28.5,100,100,12,12,213,19,194,20.1
2023-03-07T17:00,28.8,99,100,10,9,247,18,229,30.1
2023-03-07T18:00,29.1,90,100,0,0,246,29,217,35
2023-03-07T19:00,31.5,100,100,21,0,244,27,217,45.4
2023-03-07T20:00,31.5,100,100,53,0,147,0,147,20.7
2023-03-07T21:00,31.7,100,100,60,0,118,9,109,9.4
2023-03-07T22:00,32,100,99,99,0,75,1,74,13
2023-03-07T23:00,31.7,100,72,100,0,19,1,18,5.6
2023-03-08T00:00,31.5,100,80,99,0,0,0,0,0
2023-03-08T01:00,30.8,100,91,95,0,0,0,0,0
2023-03-08T02:00,29.8,100,94,75,0,0,0,0,0
2023-03-08T03:00,28.9,80,86,5,0,0,0,0,0
2023-03-08T04:00,28.2,77,84,2,0,0,0,0,0
2023-03-08T05:00,27.8,81,89,1,0,0,0,0,0
2023-03-08T06:00,27.4,91,98,4,0,0,0,0,0
2023-03-08T07:00,28.8,94,100,6,0,0,0,0,0
2023-03-08T08:00,28.7,95,100,9,0,0,0,0,0
2023-03-08T09:00,28.4,95,100,8,0,0,0,0,0
2023-03-08T10:00,27.9,92,100,4,0,0,0,0,0
2023-03-08T11:00,27.5,92,100,3,0,0,0,0,0
2023-03-08T12:00,27,89,99,0,0,3,0,3,0
2023-03-08T13:00,27.2,90,100,0,0,45,5,40,14.9
2023-03-08T14:00,27.5,90,100,0,0,105,2,103,16.5
2023-03-08T15:00,28.2,90,100,0,0,188,30,158,32.3
2023-03-08T16:00,28.8,90,100,0,0,229,34,195,63.3
2023-03-08T17:00,29.3,90,100,0,0,223,6,217,32.8
2023-03-08T18:00,30.3,80,89,0,0,313,13,300,1.6
2023-03-08T19:00,34.4,45,50,0,0,604,383,221,299.9
2023-03-08T20:00,34.7,50,55,0,0,539,395,144,680.1
2023-03-08T21:00,34,64,71,0,0,390,278,112,689.5
2023-03-08T22:00,32.5,38,42,0,0,213,127,86,562.3
2023-03-08T23:00,31.1,23,25,0,0,51,22,29,284.5
2023-03-09T00:00,30.4,8,9,0,0,0,0,0,0
2023-03-09T01:00,29.7,5,5,0,0,0,0,0,0
2023-03-09T02:00,29.7,6,7,0,0,0,0,0,0
2023-03-09T03:00,29.9,16,18,0,0,0,0,0,0
2023-03-09T04:00,30.5,23,25,0,0,0,0,0,0
2023-03-09T05:00,30.4,23,26,0,0,0,0,0,0
2023-03-09T06:00,30.3,24,27,0,0,0,0,0,0
2023-03-09T07:00,30.1,14,16,0,0,0,0,0,0
2023-03-09T08:00,30.1,24,27,0,0,0,0,0,0
2023-03-09T09:00,29.7,42,47,0,0,0,0,0,0
2023-03-09T10:00,29.4,41,45,0,0,0,0,0,0
2023-03-09T11:00,28.8,50,55,0,0,0,0,0,0
2023-03-09T12:00,28.5,63,70,0,0,5,1,4,0
2023-03-09T13:00,28.8,85,94,0,0,71,19,52,72.2
2023-03-09T14:00,29.2,90,100,0,0,114,0,114,56.7
2023-03-09T15:00,30.2,90,100,0,0,202,7,195,2.1
2023-03-09T16:00,31.1,90,100,0,0,269,57,212,56.2
2023-03-09T17:00,31.7,92,100,3,0,311,29,282,74.5
2023-03-09T18:00,32.1,97,100,12,0,296,2,294,14.8
2023-03-09T19:00,34.5,93,88,23,0,358,113,245,76.8
2023-03-09T20:00,35.4,34,38,0,0,430,222,208,278.2
2023-03-09T21:00,35.4,8,9,0,0,406,305,101,557
2023-03-09T22:00,34,5,6,0,0,242,176,66,689
2023-03-09T23:00,31.8,3,3,0,0,66,40,26,430.5
2023-03-10T00:00,30.3,6,7,0,0,0,0,0,0.2
2023-03-10T01:00,29.7,1,1,0,0,0,0,0,0
2023-03-10T02:00,29.1,2,2,0,0,0,0,0,0
2023-03-10T03:00,29.1,4,4,0,0,0,0,0,0
2023-03-10T04:00,29.2,25,8,0,60,0,0,0,0
2023-03-10T05:00,29.1,36,7,0,99,0,0,0,0
2023-03-10T06:00,29.1,35,5,0,100,0,0,0,0
2023-03-10T07:00,28.7,33,3,0,100,0,0,0,0
2023-03-10T08:00,22.8,30,0,0,100,0,0,0,0
2023-03-10T09:00,29,31,1,0,100,0,0,0,0
2023-03-10T10:00,29.8,32,0,3,100,0,0,0,0
2023-03-10T11:00,30.3,44,0,24,100,0,0,0,0
2023-03-10T12:00,30.6,78,0,80,100,7,0,7,0
2023-03-10T13:00,32,90,0,100,100,88,19,69,48.6
2023-03-10T14:00,34.2,86,0,100,88,212,53,159,125.4
2023-03-10T15:00,37,72,0,99,42,332,130,202,206
2023-03-10T16:00,39.8,68,0,100,28,413,144,269,256.1
2023-03-10T17:00,41,70,4,100,22,339,105,234,202
2023-03-10T18:00,41.2,79,8,100,38,223,13,210,86.3
2023-03-10T19:00,38.1,89,30,100,8,133,0,133,3.7
2023-03-10T20:00,37.6,100,78,100,0,107,1,106,0.4
2023-03-10T21:00,36.8,100,92,100,2,86,3,83,4.8
2023-03-10T22:00,36.2,100,98,100,8,41,0,41,3.1
2023-03-10T23:00,35.8,100,99,100,3,17,1,16,0
2023-03-11T00:00,35.1,100,99,100,24,0,0,0,0
2023-03-11T01:00,35.4,100,100,100,60,0,0,0,0
2023-03-11T02:00,35.4,100,100,100,88,0,0,0,0
2023-03-11T03:00,35.3,100,100,98,88,0,0,0,0
2023-03-11T04:00,35.2,100,100,100,97,0,0,0,0
2023-03-11T05:00,35.2,100,100,100,96,0,0,0,0
2023-03-11T06:00,35.1,100,100,100,95,0,0,0,0
2023-03-11T07:00,33.6,100,100,100,91,0,0,0,0
2023-03-11T08:00,33.1,100,100,100,95,0,0,0,0
2023-03-11T09:00,32.4,100,100,100,88,0,0,0,0
2023-03-11T10:00,31.8,100,100,100,98,0,0,0,0
2023-03-11T11:00,31.2,100,95,98,100,0,0,0,0
2023-03-11T12:00,30.6,100,98,80,100,5,0,5,0
2023-03-11T13:00,30.6,100,100,84,99,55,0,55,0
2023-03-11T14:00,31.1,100,99,84,97,158,13,145,18.5
2023-03-11T15:00,31.5,100,100,56,82,203,8,195,27.7
2023-03-11T16:00,31.7,100,100,23,34,227,4,223,10
2023-03-11T17:00,32.3,93,100,5,0,293,10,283,10.1
2023-03-11T18:00,33.2,90,100,0,0,361,11,350,12
2023-03-11T19:00,34.1,93,100,3,3,436,68,368,59.8
2023-03-11T20:00,34,87,96,0,2,323,53,270,102.6
2023-03-11T21:00,33.6,91,100,0,2,261,37,224,86
2023-03-11T22:00,32.9,92,95,0,20,157,36,121,107.1
2023-03-11T23:00,31.6,84,90,0,11,40,5,35,79.8
2023-03-12T00:00,30.8,79,88,0,0,0,0,0,0.2
2023-03-12T01:00,29.6,79,88,0,0,0,0,0,0
2023-03-12T02:00,29.2,77,85,0,0,0,0,0,0
2023-03-12T03:00,28.8,73,81,0,0,0,0,0,0
2023-03-12T04:00,28.3,73,81,0,0,0,0,0,0
2023-03-12T05:00,27.9,67,74,0,0,0,0,0,0
2023-03-12T06:00,27.8,33,37,0,0,0,0,0,0
2023-03-12T07:00,27.4,7,8,0,0,0,0,0,0
2023-03-12T08:00,26.6,10,11,0,0,0,0,0,0
2023-03-12T09:00,26.1,14,15,0,0,0,0,0,0
2023-03-12T10:00,25.5,23,25,0,0,0,0,0,0
2023-03-12T11:00,25,38,26,0,47,0,0,0,0
2023-03-12T12:00,24.9,46,51,0,2,15,7,8,0
2023-03-12T13:00,27,39,10,0,100,157,97,60,331.5
2023-03-12T14:00,31.2,30,0,0,100,318,172,146,500.6
2023-03-12T15:00,34.2,30,0,0,100,444,195,249,424.9
2023-03-12T16:00,36.8,31,1,0,100,531,222,309,367
2023-03-12T17:00,39.2,55,28,0,100,596,231,365,354.5
2023-03-12T18:00,40.7,48,20,0,100,548,128,420,260.5
2023-03-12T19:00,41.7,31,0,1,100,521,144,377,199.7
2023-03-12T20:00,42.3,74,0,76,96,347,58,289,164.9
2023-03-12T21:00,42.3,68,5,85,42,235,17,218,64.2
2023-03-12T22:00,41.1,62,1,98,7,128,17,111,46.5
2023-03-12T23:00,39.2,84,0,93,93,37,4,33,42.6
2023-03-13T00:00,37.6,91,2,98,100,0,0,0,0.2
2023-03-13T01:00,37.7,96,10,95,100,0,0,0,0
2023-03-13T02:00,37.1,100,41,97,96,0,0,0,0
2023-03-13T03:00,36.7,100,66,97,93,0,0,0,0
2023-03-13T04:00,36.4,100,78,96,88,0,0,0,0
2023-03-13T05:00,36.2,100,90,96,42,0,0,0,0
2023-03-13T06:00,36,100,88,96,1,0,0,0,0
2023-03-13T07:00,36.3,100,83,90,0,0,0,0,0
2023-03-13T08:00,36,100,93,83,0,0,0,0,0
2023-03-13T09:00,36.1,100,94,90,0,0,0,0,0
2023-03-13T10:00,36.2,100,95,93,0,0,0,0,0
2023-03-13T11:00,36.1,100,95,95,0,0,0,0,0
2023-03-13T12:00,36.2,100,91,93,0,6,1,5,0
2023-03-13T13:00,36.8,100,88,92,31,46,2,44,13.6
2023-03-13T14:00,38.2,100,90,97,39,155,33,122,50.2
2023-03-13T15:00,38.9,100,87,91,2,195,20,175,67.1
2023-03-13T16:00,39.7,100,93,94,0,235,28,207,38.6
2023-03-13T17:00,40.7,100,93,94,0,246,49,197,60.5
2023-03-13T18:00,40.4,100,98,96,0,180,9,171,43.4
2023-03-13T19:00,40.4,100,99,98,0,163,14,149,14.6
2023-03-13T20:00,40,100,100,100,0,165,9,156,19.4
2023-03-13T21:00,39.3,100,100,100,0,101,0,101,7.5
2023-03-13T22:00,37.6,100,100,100,0,59,1,58,1.5
2023-03-13T23:00,36.6,100,100,98,0,18,0,18,1.3
2023-03-14T00:00,36.1,100,100,100,0,0,0,0,0
2023-03-14T01:00,35,100,99,99,0,0,0,0,0
2023-03-14T02:00,34.1,100,99,100,0,0,0,0,0
2023-03-14T03:00,33.3,100,97,100,0,0,0,0,0
2023-03-14T04:00,32.8,100,97,97,0,0,0,0,0
2023-03-14T05:00,32.2,100,99,100,0,0,0,0,0
2023-03-14T06:00,31.5,100,99,96,0,0,0,0,0
2023-03-14T07:00,31.7,100,97,92,0,0,0,0,0
2023-03-14T08:00,31.5,100,94,93,0,0,0,0,0
2023-03-14T09:00,30.6,100,96,95,0,0,0,0,0
2023-03-14T10:00,30.1,100,95,100,0,0,0,0,0
2023-03-14T11:00,29.7,100,96,100,1,0,0,0,0
2023-03-14T12:00,29.7,100,98,100,2,6,0,6,0
2023-03-14T13:00,30.2,100,99,100,2,42,0,42,0
2023-03-14T14:00,30.8,100,100,100,4,93,0,93,0
2023-03-14T15:00,31.1,100,100,100,11,131,0,131,0
2023-03-14T16:00,31,100,100,100,80,174,1,173,0.2
2023-03-14T17:00,31.1,100,100,100,100,211,11,200,9.2
2023-03-14T18:00,31.3,100,100,100,100,205,3,202,10.6
2023-03-14T19:00,30.9,100,100,100,100,222,6,216,6.5
2023-03-14T20:00,31.1,100,100,100,99,188,1,187,5.7
2023-03-14T21:00,31,100,100,100,97,106,0,106,0.4
2023-03-14T22:00,30.8,100,100,100,95,73,0,73,0
2023-03-14T23:00,30.8,100,100,100,90,26,0,26,0
2023-03-15T00:00,30.7,100,100,100,98,0,0,0,0
2023-03-15T01:00,30.5,100,100,99,100,0,0,0,0
2023-03-15T02:00,30.4,100,100,100,100,0,0,0,0
2023-03-15T03:00,30.1,100,100,100,90,0,0,0,0
2023-03-15T04:00,29.7,100,100,100,36,0,0,0,0
2023-03-15T05:00,29.1,100,100,100,31,0,0,0,0
2023-03-15T06:00,28.3,100,100,100,31,0,0,0,0
2023-03-15T07:00,29,100,98,98,25,0,0,0,0
2023-03-15T08:00,28.1,100,82,73,20,0,0,0,0
2023-03-15T09:00,27.2,77,68,24,4,0,0,0,0
2023-03-15T10:00,26.2,61,41,35,9,0,0,0,0
2023-03-15T11:00,25.6,60,36,40,13,0,0,0,0
2023-03-15T12:00,25.2,29,27,5,5,12,3,9,0
2023-03-15T13:00,25.7,20,21,1,0,103,33,70,104.4
2023-03-15T14:00,26.5,56,62,0,0,232,85,147,191
2023-03-15T15:00,28,53,59,0,0,352,132,220,236.3
2023-03-15T16:00,29.7,64,71,0,0,472,188,284,264.8
2023-03-15T17:00,32.1,7,8,0,0,620,358,262,392.9
2023-03-15T18:00,34.4,0,0,0,0,761,572,189,660.4
2023-03-15T19:00,36,2,2,0,0,754,644,110,894
2023-03-15T20:00,36.6,0,0,0,0,650,550,100,957.6
2023-03-15T21:00,36.5,0,0,0,0,482,391,91,896.9
2023-03-15T22:00,35.5,0,0,0,0,292,221,71,796.8
2023-03-15T23:00,33.2,2,2,0,0,96,62,34,563.2
2023-03-16T00:00,31.3,0,0,0,0,1,0,1,10.8
2023-03-16T01:00,28.7,0,0,0,0,0,0,0,0
2023-03-16T02:00,27,0,0,0,0,0,0,0,0
2023-03-16T03:00,26.5,4,0,7,0,0,0,0,0
2023-03-16T04:00,25.3,20,0,33,0,0,0,0,0
2023-03-16T05:00,25,0,0,0,0,0,0,0,0
2023-03-16T06:00,23.9,2,0,0,6,0,0,0,0
2023-03-16T07:00,25.2,7,0,8,7,0,0,0,0
2023-03-16T08:00,24.6,11,2,14,1,0,0,0,0
2023-03-16T09:00,25.2,49,1,45,71,0,0,0,0
2023-03-16T10:00,25.3,40,10,52,0,0,0,0,0
2023-03-16T11:00,26.4,35,13,31,16,0,0,0,0
2023-03-16T12:00,26.4,18,7,12,14,23,12,11,0
2023-03-16T13:00,29,27,21,14,0,180,122,58,382.7
2023-03-16T14:00,35.1,14,11,6,0,381,301,80,675.8
2023-03-16T15:00,38.6,15,13,6,0,557,466,91,830.3
2023-03-16T16:00,41.1,22,17,10,2,683,575,108,891
2023-03-16T17:00,42.7,14,13,4,0,749,610,139,883.5
2023-03-16T18:00,43.7,11,9,4,1,772,650,122,891.2
2023-03-16T19:00,51.3,36,7,37,24,708,568,140,884.9
2023-03-16T20:00,51.7,34,0,56,0,545,387,158,745.2
2023-03-16T21:00,51.4,43,0,71,0,437,306,131,659.6
2023-03-16T22:00,48.7,60,0,95,11,237,118,119,535.3
2023-03-16T23:00,46.9,82,0,91,92,70,16,54,234.2
2023-03-17T00:00,43.1,82,0,86,100,1,0,1,3.5
2023-03-17T01:00,42,35,0,9,98,0,0,0,0
2023-03-17T02:00,41.3,30,0,0,100,0,0,0,0
2023-03-17T03:00,40.7,60,0,50,100,0,0,0,0
2023-03-17T04:00,40.4,70,0,68,98,0,0,0,0
2023-03-17T05:00,39.5,87,0,95,99,0,0,0,0
2023-03-17T06:00,39.1,89,0,99,100,0,0,0,0
2023-03-17T07:00,41.3,97,8,100,100,0,0,0,0
2023-03-17T08:00,40.6,100,95,100,100,0,0,0,0
2023-03-17T09:00,40.4,100,100,100,100,0,0,0,0
2023-03-17T10:00,40.9,100,100,100,32,0,0,0,0
2023-03-17T11:00,41.4,100,100,100,100,0,0,0,0
2023-03-17T12:00,41.8,100,94,56,100,6,0,6,0
2023-03-17T13:00,42.6,100,100,100,100,25,0,25,0
2023-03-17T14:00,43.8,100,100,100,100,44,0,44,0
2023-03-17T15:00,44.3,100,98,100,100,52,0,52,0
2023-03-17T16:00,45.4,100,100,100,100,69,0,69,0
2023-03-17T17:00,46.3,100,100,100,100,100,0,100,0
2023-03-17T18:00,46.6,100,100,100,87,100,0,100,0
2023-03-17T19:00,46.8,100,98,67,34,125,8,117,5.9
2023-03-17T20:00,46.9,100,95,52,46,99,5,94,9.1
2023-03-17T21:00,45.9,100,98,20,6,140,21,119,26.9
2023-03-17T22:00,45.8,100,100,79,6,80,9,71,37.9
2023-03-17T23:00,44.3,100,95,100,0,20,6,14,35.3
2023-03-18T00:00,43.7,100,84,84,0,0,0,0,1.6
2023-03-18T01:00,42.8,100,95,24,0,0,0,0,0
2023-03-18T02:00,40.3,91,98,5,0,0,0,0,0
2023-03-18T03:00,38.4,78,85,2,0,0,0,0,0
2023-03-18T04:00,37.3,77,84,2,0,0,0,0,0
2023-03-18T05:00,36.6,85,94,0,0,0,0,0,0
2023-03-18T06:00,35.2,78,87,0,0,0,0,0,0
2023-03-18T07:00,35.1,81,90,0,0,0,0,0,0
2023-03-18T08:00,34.2,84,93,0,0,0,0,0,0
2023-03-18T09:00,33.8,85,94,0,0,0,0,0,0
2023-03-18T10:00,33.3,85,94,0,0,0,0,0,0
2023-03-18T11:00,33.1,76,84,0,0,0,0,0,0
2023-03-18T12:00,33,55,61,0,0,24,9,15,0
2023-03-18T13:00,34.1,26,29,0,0,136,47,89,175.9
2023-03-18T14:00,35.3,85,62,48,0,267,116,151,256.9
2023-03-18T15:00,36.8,76,36,73,0,315,58,257,199.2
2023-03-18T16:00,38.2,59,26,59,0,405,132,273,143.6
2023-03-18T17:00,39.1,48,19,52,0,487,189,298,223.9
2023-03-18T18:00,40.3,37,12,43,0,679,434,245,430.6
2023-03-18T19:00,41,44,11,56,0,653,444,209,639.6
2023-03-18T20:00,40.2,55,18,65,0,536,355,181,630.1
2023-03-18T21:00,38.6,74,27,82,0,344,189,155,500.5
2023-03-18T22:00,37,53,5,80,0,184,82,102,327
2023-03-18T23:00,35.6,37,4,56,0,71,24,47,210.5
2023-03-19T00:00,33.8,58,20,66,0,2,0,2,7.5
2023-03-19T01:00,32.2,84,43,76,0,0,0,0,0
2023-03-19T02:00,29.8,35,12,40,0,0,0,0,0
2023-03-19T03:00,28.7,16,14,6,0,0,0,0,0
2023-03-19T04:00,28.1,8,9,0,0,0,0,0,0
2023-03-19T05:00,27.8,52,48,14,0,0,0,0,0
2023-03-19T06:00,27.7,66,44,44,0,0,0,0,0
2023-03-19T07:00,27,69,29,72,0,0,0,0,0
2023-03-19T08:00,27,92,47,83,0,0,0,0,0
2023-03-19T09:00,26.9,100,65,70,0,0,0,0,0
2023-03-19T10:00,27.1,94,72,48,0,0,0,0,0
2023-03-19T11:00,27.1,90,59,61,0,0,0,0,0
2023-03-19T12:00,27,100,88,73,0,22,6,16,0
2023-03-19T13:00,27.7,100,100,100,0,130,39,91,130
2023-03-19T14:00,28.8,100,100,100,0,260,85,175,191.3
2023-03-19T15:00,30,100,100,100,0,356,107,249,203.1
2023-03-19T16:00,31.5,100,100,100,0,454,142,312,203.5
2023-03-19T17:00,32.7,100,91,100,0,538,179,359,234.9
2023-03-19T18:00,33.8,60,1,99,0,527,164,363,235.2
2023-03-19T19:00,34.5,64,6,98,0,558,221,337,269.3
2023-03-19T20:00,35,69,10,100,0,495,218,277,345.8
2023-03-19T21:00,34.9,100,73,100,0,364,154,210,347.5
2023-03-19T22:00,34.1,100,100,93,0,214,73,141,273.4
2023-03-19T23:00,32.5,82,68,34,0,83,39,44,248.7
2023-03-20T00:00,31.1,46,32,28,0,2,0,2,14.2
2023-03-20T01:00,29.8,14,16,0,0,0,0,0,0
2023-03-20T02:00,29.3,5,6,0,0,0,0,0,0
2023-03-20T03:00,29.1,2,2,0,0,0,0,0,0
2023-03-20T04:00,29.1,0,0,0,0,0,0,0,0
2023-03-20T05:00,29.3,0,0,0,0,0,0,0,0
2023-03-20T06:00,29.4,0,0,0,0,0,0,0,0
2023-03-20T07:00,29.7,0,0,0,0,0,0,0,0
2023-03-20T08:00,29.8,0,0,0,0,0,0,0,0
2023-03-20T09:00,29.7,0,0,0,0,0,0,0,0
2023-03-20T10:00,29.5,0,0,0,0,0,0,0,0
2023-03-20T11:00,29.3,0,0,0,0,0,0,0,0
2023-03-20T12:00,29.9,0,0,0,0,37,22,15,0
2023-03-20T13:00,32.3,0,0,0,0,211,157,54,490
2023-03-20T14:00,35.2,0,0,0,0,412,338,74,747.2
2023-03-20T15:00,38.2,0,0,0,0,589,503,86,868.7
2023-03-20T16:00,41,17,0,19,20,721,628,93,930.8
2023-03-20T17:00,43.4,22,1,19,33,798,702,96,963.4
2023-03-20T18:00,45.2,13,0,5,33,812,715,97,976.5
2023-03-20T19:00,46.6,2,0,1,6,760,659,101,963.2
2023-03-20T20:00,47.2,0,0,0,0,656,569,87,943.7
2023-03-20T21:00,46.8,6,0,6,9,499,421,78,910.3
2023-03-20T22:00,42.7,25,0,28,26,306,240,66,820
2023-03-20T23:00,41.8,26,0,35,16,108,69,39,608.4
2023-03-21T00:00,39.5,22,0,33,8,3,1,2,28.7
2023-03-21T01:00,37.1,45,0,54,41,0,0,0,0
2023-03-21T02:00,36.2,68,0,77,74,0,0,0,0
2023-03-21T03:00,35.8,67,0,74,74,0,0,0,0
2023-03-21T04:00,35.4,73,0,83,76,0,0,0,0
2023-03-21T05:00,34.7,71,0,79,78,0,0,0,0
2023-03-21T06:00,34.3,54,0,63,55,0,0,0,0
2023-03-21T07:00,35.2,78,0,84,93,0,0,0,0
2023-03-21T08:00,34.9,86,0,95,97,0,0,0,0
2023-03-21T09:00,35,83,0,92,94,0,0,0,0
2023-03-21T10:00,31.7,38,0,43,40,0,0,0,0
2023-03-21T11:00,35.5,15,0,25,0,0,0,0,0
2023-03-21T12:00,36.2,19,0,31,0,33,17,16,0
2023-03-21T13:00,39.3,6,0,10,0,185,135,50,394
2023-03-21T14:00,43.4,7,0,11,0,383,294,89,633.4
2023-03-21T15:00,44.6,18,0,30,0,565,478,87,783.1
2023-03-21T16:00,46.5,11,0,19,0,693,596,97,881.1
2023-03-21T17:00,48,11,0,19,0,755,632,123,886.6
2023-03-21T18:00,49.7,10,0,17,0,757,610,147,847.6
2023-03-21T19:00,52,14,0,24,0,709,586,123,832.4
2023-03-21T20:00,53.3,16,0,16,21,613,495,118,831.7
2023-03-21T21:00,51.9,31,0,4,95,432,305,127,721.4
2023-03-21T22:00,47.4,32,0,3,100,271,182,89,594.7
2023-03-21T23:00,46.2,31,0,1,100,102,56,46,474
2023-03-22T00:00,42.8,32,0,4,97,3,0,3,26
2023-03-22T01:00,39.7,57,0,53,85,0,0,0,0
2023-03-22T02:00,37.8,57,0,55,81,0,0,0,0
2023-03-22T03:00,36.6,72,0,74,93,0,0,0,0
2023-03-22T04:00,35.4,77,0,86,83,0,0,0,0
2023-03-22T05:00,34.9,86,0,97,94,0,0,0,0
2023-03-22T06:00,34.5,88,0,97,98,0,0,0,0
2023-03-22T07:00,35.1,86,0,93,100,0,0,0,0
2023-03-22T08:00,35,85,0,92,100,0,0,0,0
2023-03-22T09:00,31.5,87,0,95,100,0,0,0,0
2023-03-22T10:00,36.7,89,0,98,99,0,0,0,0
2023-03-22T11:00,37.6,85,0,91,100,0,0,0,0
2023-03-22T12:00,38.7,89,0,98,100,19,0,19,0
2023-03-22T13:00,41.7,84,0,96,88,107,15,92,24.6
2023-03-22T14:00,42.1,40,0,66,0,251,73,178,107.9
2023-03-22T15:00,45.9,13,0,22,0,440,233,207,286.7
2023-03-22T16:00,47.5,25,0,12,58,637,413,224,511.8
2023-03-22T17:00,51.2,29,0,0,96,764,631,133,751.7
2023-03-22T18:00,54.9,73,0,74,96,746,538,208,827
2023-03-22T19:00,55.4,94,6,99,98,435,150,285,474.3
2023-03-22T20:00,53.2,89,5,97,88,252,36,216,116.7
2023-03-22T21:00,50.9,77,16,95,20,127,19,108,40.2
2023-03-22T22:00,48.8,57,7,83,4,95,29,66,62.1
2023-03-22T23:00,50.6,91,17,78,95,37,13,24,91.1
2023-03-23T00:00,48.1,100,37,76,95,1,0,1,6.9
2023-03-23T01:00,46.8,91,22,84,68,0,0,0,0
2023-03-23T02:00,46.7,100,71,96,45,0,0,0,0
2023-03-23T03:00,47,100,100,98,24,0,0,0,0
2023-03-23T04:00,47.4,100,83,75,4,0,0,0,0
2023-03-23T05:00,47.5,100,54,50,96,0,0,0,0
2023-03-23T06:00,46.8,100,47,80,93,0,0,0,0
2023-03-23T07:00,46.3,100,71,100,98,0,0,0,0
2023-03-23T08:00,40.5,100,100,97,100,0,0,0,0
2023-03-23T09:00,40.6,100,100,95,90,0,0,0,0
2023-03-23T10:00,41.4,100,82,92,83,0,0,0,0
2023-03-23T11:00,43.1,100,100,82,39,0,0,0,0
2023-03-23T12:00,44.7,100,100,71,97,4,0,4,0
2023-03-23T13:00,46,100,100,56,95,22,0,22,0
2023-03-23T14:00,47.7,100,100,61,70,42,0,42,0
2023-03-23T15:00,48.8,100,100,94,25,65,1,64,0.6
2023-03-23T16:00,49.1,100,97,95,2,88,4,84,3.4
2023-03-23T17:00,50.3,100,100,94,0,90,12,78,11.8
2023-03-23T18:00,51.7,100,100,100,54,96,1,95,9.4
2023-03-23T19:00,53.1,100,100,98,97,64,0,64,0.1
2023-03-23T20:00,53.4,100,100,100,66,39,0,39,0
2023-03-23T21:00,52.4,100,100,100,0,58,0,58,0
2023-03-23T22:00,49.5,100,100,100,28,17,0,17,0
2023-03-23T23:00,46.7,100,100,99,0,9,1,8,4
2023-03-24T00:00,44.1,100,86,87,0,1,0,1,0
2023-03-24T01:00,42.9,91,68,50,0,0,0,0,0
2023-03-24T02:00,42,58,40,36,0,0,0,0,0
2023-03-24T03:00,40.5,23,25,0,1,0,0,0,0
2023-03-24T04:00,38.3,29,28,0,14,0,0,0,0
2023-03-24T05:00,35.8,55,29,0,97,0,0,0,0
2023-03-24T06:00,33.9,51,24,0,97,0,0,0,0
2023-03-24T07:00,33.3,53,25,0,100,0,0,0,0
2023-03-24T08:00,32.7,44,16,0,100,0,0,0,0
2023-03-24T09:00,32.1,43,14,0,100,0,0,0,0
2023-03-24T10:00,31.9,51,23,0,100,0,0,0,0
2023-03-24T11:00,31.6,45,17,0,100,0,0,0,0
2023-03-24T12:00,32,36,7,0,100,24,1,23,0
2023-03-24T13:00,33.1,57,30,0,100,111,7,104,19.8
2023-03-24T14:00,34.2,85,73,0,64,180,13,167,24.5
2023-03-24T15:00,36.1,100,98,0,100,342,81,261,82.3
2023-03-24T16:00,38.5,100,87,0,100,445,133,312,166.9
2023-03-24T17:00,41.4,83,65,0,82,581,237,344,256.6
2023-03-24T18:00,43.2,54,27,0,100,631,284,347,343.9
2023-03-24T19:00,45.9,30,0,0,100,683,439,244,505.7
2023-03-24T20:00,45.5,29,0,0,95,523,270,253,532.3
2023-03-24T21:00,44.7,30,0,0,100,433,261,172,476.5
2023-03-24T22:00,43.6,30,0,0,100,263,128,135,472.9
2023-03-24T23:00,40.9,30,0,0,100,72,5,67,203.8
2023-03-25T00:00,38.2,30,0,0,100,4,0,4,1.9
2023-03-25T01:00,36,30,0,0,100,0,0,0,0
2023-03-25T02:00,34.6,30,0,0,100,0,0,0,0
2023-03-25T03:00,33.3,30,0,0,100,0,0,0,0
2023-03-25T04:00,33,29,0,0,97,0,0,0,0
2023-03-25T05:00,32.9,30,0,0,99,0,0,0,0
2023-03-25T06:00,33,30,0,0,100,0,0,0,0
2023-03-25T07:00,33.1,31,0,1,100,0,0,0,0
2023-03-25T08:00,33.3,36,0,10,100,0,0,0,0
2023-03-25T09:00,34.2,53,0,39,100,0,0,0,0
2023-03-25T10:00,35.9,86,0,93,100,0,0,0,0
2023-03-25T11:00,35.9,90,0,100,100,0,0,0,0
2023-03-25T12:00,33.9,90,0,100,100,7,0,7,0
2023-03-25T13:00,34.7,100,69,100,100,19,0,19,0
2023-03-25T14:00,35.3,100,96,100,100,24,0,24,0
2023-03-25T15:00,36,100,99,98,99,45,0,45,0
2023-03-25T16:00,36.9,100,90,97,98,56,0,56,0
2023-03-25T17:00,38.8,100,99,100,87,79,0,79,0
2023-03-25T18:00,39.9,100,99,78,0,67,0,67,0
2023-03-25T19:00,40,100,100,94,1,196,47,149,35.1
2023-03-25T20:00,40,100,98,69,10,53,0,53,35
2023-03-25T21:00,40.4,100,99,30,11,76,13,63,9.1
2023-03-25T22:00,40.8,100,99,46,11,64,18,46,40.1
2023-03-25T23:00,41.1,100,81,34,51,33,9,24,55.6
2023-03-26T00:00,41.2,100,91,20,43,3,1,2,6.8
2023-03-26T01:00,43,100,97,23,7,0,0,0,0
2023-03-26T02:00,44.1,100,90,39,0,0,0,0,0
2023-03-26T03:00,44.9,100,86,59,23,0,0,0,0
2023-03-26T04:00,44.5,77,61,36,2,0,0,0,0
2023-03-26T05:00,42.5,100,89,80,0,0,0,0,0
2023-03-26T06:00,41.2,100,96,81,39,0,0,0,0
2023-03-26T07:00,40.1,100,91,48,2,0,0,0,0
2023-03-26T08:00,38.9,89,87,18,0,0,0,0,0
2023-03-26T09:00,38.4,83,90,3,0,0,0,0,0
2023-03-26T10:00,37.8,90,88,18,0,0,0,0,0
2023-03-26T11:00,37.3,80,88,1,0,0,0,0,0
2023-03-26T12:00,37.8,42,47,0,0,28,10,18,0
2023-03-26T13:00,39.4,18,20,0,0,145,73,72,178.2
2023-03-26T14:00,41.8,6,7,0,0,364,262,102,424.4
2023-03-26T15:00,45,6,7,0,0,588,465,123,700.4
2023-03-26T16:00,47.9,3,3,0,0,724,604,120,837.3
2023-03-26T17:00,50.4,1,1,0,0,824,738,86,932.1
2023-03-26T18:00,52.1,0,0,0,0,836,745,91,987.8
2023-03-26T19:00,53.1,0,0,0,0,783,694,89,973.9
2023-03-26T20:00,53.3,0,0,0,0,673,587,86,948.2
2023-03-26T21:00,52.8,0,0,0,0,517,439,78,902.8
2023-03-26T22:00,51.3,1,0,0,2,326,262,64,824.8
2023-03-26T23:00,47.8,8,0,8,11,128,88,40,663
2023-03-27T00:00,44.9,40,0,56,20,7,3,4,69
2023-03-27T01:00,43.1,39,0,59,13,0,0,0,0
2023-03-27T02:00,41.4,0,0,0,0,0,0,0,0
2023-03-27T03:00,39.6,0,0,0,0,0,0,0,0
2023-03-27T04:00,37.3,0,0,0,0,0,0,0,0
2023-03-27T05:00,36.5,0,0,0,0,0,0,0,0
2023-03-27T06:00,36.6,0,0,0,0,0,0,0,0
2023-03-27T07:00,33.8,0,0,0,0,0,0,0,0
2023-03-27T08:00,33.2,0,0,0,0,0,0,0,0
2023-03-27T09:00,32.4,0,0,0,0,0,0,0,0
2023-03-27T10:00,32.1,55,2,44,88,0,0,0,0
2023-03-27T11:00,32.4,18,8,18,1,0,0,0,0
2023-03-27T12:00,33.8,57,15,32,80,48,15,33,0
2023-03-27T13:00,40.9,66,0,60,100,168,54,114,177.3
2023-03-27T14:00,45.8,80,0,84,100,313,116,197,234.7
2023-03-27T15:00,48.2,90,0,100,100,301,44,257,172.2
2023-03-27T16:00,49.5,90,0,100,100,323,27,296,49.3
2023-03-27T17:00,49.7,94,4,100,100,275,28,247,37.7
2023-03-27T18:00,49.4,92,2,100,99,236,5,231,20.7
2023-03-27T19:00,50.3,90,0,100,99,308,28,280,22.5
2023-03-27T20:00,48.3,85,1,100,79,182,2,180,22.7
2023-03-27T21:00,45.5,100,60,100,60,108,0,108,0.3
2023-03-27T22:00,43,100,97,100,75,47,1,46,1.6
2023-03-27T23:00,40.7,100,100,100,69,17,0,17,1.2
2023-03-28T00:00,37.8,100,100,100,5,1,0,1,0
2023-03-28T01:00,37.6,100,100,100,0,0,0,0,0
2023-03-28T02:00,36.8,100,100,94,0,0,0,0,0
2023-03-28T03:00,36.2,100,100,91,0,0,0,0,0
2023-03-28T04:00,36,100,100,63,0,0,0,0,0
2023-03-28T05:00,35.6,100,90,57,0,0,0,0,0
2023-03-28T06:00,35.2,100,93,80,0,0,0,0,0
2023-03-28T07:00,35.1,100,85,77,0,0,0,0,0
2023-03-28T08:00,35.1,100,82,64,0,0,0,0,0
2023-03-28T09:00,34.9,96,71,54,0,0,0,0,0
2023-03-28T10:00,34.3,77,66,29,0,0,0,0,0
2023-03-28T11:00,34,57,58,8,0,0,0,0,0
2023-03-28T12:00,33.7,47,48,6,1,44,22,22,0
2023-03-28T13:00,34.7,86,91,6,1,186,97,89,284.2
2023-03-28T14:00,37,71,78,1,0,336,163,173,342.5
2023-03-28T15:00,41.1,36,25,22,0,561,396,165,506.5
2023-03-28T16:00,44.1,52,29,39,7,674,520,154,714.7
2023-03-28T17:00,45.7,81,51,52,13,735,579,156,768.8
2023-03-28T18:00,45.9,100,81,64,4,619,350,269,619.5
2023-03-28T19:00,45.7,98,84,37,0,487,212,275,358.4
2023-03-28T20:00,45.8,98,86,34,0,476,243,233,327.3
2023-03-28T21:00,45.1,68,57,27,0,361,201,160,382.2
2023-03-28T22:00,44.1,50,26,27,36,298,200,98,489.9
2023-03-28T23:00,42.1,38,6,5,100,112,59,53,479.4
2023-03-29T00:00,39.2,38,0,14,99,7,2,5,52.6
2023-03-29T01:00,37.7,63,0,55,99,0,0,0,0
2023-03-29T02:00,36.9,79,0,81,100,0,0,0,0
2023-03-29T03:00,36.9,89,0,99,100,0,0,0,0
2023-03-29T04:00,36.2,87,0,95,99,0,0,0,0
2023-03-29T05:00,34.6,74,0,93,62,0,0,0,0
2023-03-29T06:00,34.3,34,0,51,11,0,0,0,0
2023-03-29T07:00,34.4,15,0,19,11,0,0,0,0
2023-03-29T08:00,33.6,2,0,4,0,0,0,0,0
2023-03-29T09:00,30.7,0,0,0,0,0,0,0,0
2023-03-29T10:00,31.4,0,0,0,0,0,0,0,0
2023-03-29T11:00,31.1,3,0,0,11,0,0,0,0
2023-03-29T12:00,33.4,14,4,1,31,68,44,24,0
2023-03-29T13:00,40,13,11,1,8,251,190,61,539.1
2023-03-29T14:00,44,22,9,6,35,442,358,84,724.7
2023-03-29T15:00,47.2,48,2,41,73,608,501,107,813.7
2023-03-29T16:00,49.5,79,7,74,95,696,543,153,814.4
2023-03-29T17:00,50.8,83,0,90,95,674,409,265,654.2
2023-03-29T18:00,51.5,80,0,87,93,652,381,271,501.7
2023-03-29T19:00,52.9,65,0,76,65,674,420,254,523.3
2023-03-29T20:00,53.3,68,0,83,59,622,491,131,682.3
2023-03-29T21:00,52.4,87,0,96,97,410,239,171,635.7
2023-03-29T22:00,49.3,83,0,95,88,179,59,120,310.9
2023-03-29T23:00,43.4,100,63,94,31,50,5,45,87.7
2023-03-30T00:00,36.8,100,84,100,10,3,0,3,3.5
2023-03-30T01:00,33.1,84,32,91,1,0,0,0,0
2023-03-30T02:00,32,52,48,14,0,0,0,0,0
2023-03-30T03:00,31.3,60,66,1,0,0,0,0,0
2023-03-30T04:00,30.3,41,43,3,0,0,0,0,0
2023-03-30T05:00,29.4,30,32,2,0,0,0,0,0
2023-03-30T06:00,28.4,47,46,10,0,0,0,0,0
2023-03-30T07:00,28,48,44,14,0,0,0,0,0
2023-03-30T08:00,27.7,51,47,15,0,0,0,0,0
2023-03-30T09:00,27.1,65,69,5,0,0,0,0,0
2023-03-30T10:00,26.9,81,87,4,0,0,0,0,0
2023-03-30T11:00,26.6,99,85,37,0,0,0,0,0
2023-03-30T12:00,27.3,98,81,41,0,61,27,34,0
2023-03-30T13:00,28.6,100,100,52,0,186,55,131,216
2023-03-30T14:00,30.2,100,100,49,0,335,135,200,238.2
2023-03-30T15:00,31.6,100,100,24,0,426,131,295,252.8
2023-03-30T16:00,33.9,94,100,7,0,572,247,325,277.5
2023-03-30T17:00,35.8,100,100,22,0,602,274,328,352.7
2023-03-30T18:00,37.9,89,48,76,0,676,376,300,409.6
2023-03-30T19:00,39.9,43,4,65,0,743,537,206,607.6
2023-03-30T20:00,40.5,4,4,0,0,667,514,153,770.5
2023-03-30T21:00,40.5,0,0,0,0,522,423,99,808
2023-03-30T22:00,39.8,0,0,0,0,348,282,66,811.4
2023-03-30T23:00,37.3,0,0,0,0,145,102,43,702.5
2023-03-31T00:00,34.4,1,0,0,2,10,5,5,105.7
2023-03-31T01:00,31.7,25,0,0,83,0,0,0,0
2023-03-31T02:00,29.7,29,0,0,98,0,0,0,0
2023-03-31T03:00,28.6,29,0,2,91,0,0,0,0
2023-03-31T04:00,28.9,23,0,0,76,0,0,0,0
2023-03-31T05:00,28.8,15,0,0,49,0,0,0,0
2023-03-31T06:00,29.2,11,0,0,37,0,0,0,0
2023-03-31T07:00,30,63,0,55,100,0,0,0,0
2023-03-31T08:00,31.4,89,0,98,100,0,0,0,0
2023-03-31T09:00,32.2,90,0,100,100,0,0,0,0
2023-03-31T10:00,33,91,1,100,100,0,0,0,0
2023-03-31T11:00,33.8,98,9,100,100,0,0,0,0
2023-03-31T12:00,35.3,94,4,100,100,35,0,35,0
2023-03-31T13:00,37.6,89,1,96,100,98,4,94,1.3
2023-03-31T14:00,41.9,95,5,100,100,267,77,190,94.6
2023-03-31T15:00,43.2,90,0,100,100,188,1,187,89.9
2023-03-31T16:00,45,89,0,99,100,241,12,229,4.6
2023-03-31T17:00,45.2,90,0,100,100,176,11,165,16.6
2023-03-31T18:00,42.3,100,84,100,100,124,2,122,8.5
2023-03-31T19:00,42.7,100,100,100,99,95,0,95,0.7
2023-03-31T20:00,42.5,100,100,98,84,64,0,64,0
2023-03-31T21:00,42.6,100,100,96,91,57,0,57,0
2023-03-31T22:00,43,100,100,100,98,42,0,42,0
2023-03-31T23:00,43.4,100,100,100,96,12,1,11,4
2023-04-01T00:00,44.3,100,100,100,74,1,0,1,0
2023-04-01T01:00,44.1,100,100,100,58,0,0,0,0
2023-04-01T02:00,44.5,100,100,100,83,0,0,0,0
2023-04-01T03:00,45,100,100,95,100,0,0,0,0
2023-04-01T04:00,45.4,100,98,57,96,0,0,0,0
2023-04-01T05:00,45.9,100,94,99,100,0,0,0,0
2023-04-01T06:00,46.7,100,100,89,100,0,0,0,0
2023-04-01T07:00,46.7,90,31,53,100,0,0,0,0
2023-04-01T08:00,47.2,70,2,63,100,0,0,0,0
2023-04-01T09:00,48.2,59,8,37,99,0,0,0,0
2023-04-01T10:00,49.2,92,36,52,96,0,0,0,0
2023-04-01T11:00,50.9,100,49,98,12,0,0,0,0
2023-04-01T12:00,51.3,100,49,77,32,33,6,27,0
2023-04-01T13:00,52.5,51,33,36,0,87,25,62,53.2
2023-04-01T14:00,55.1,28,31,0,0,306,186,120,224.7
2023-04-01T15:00,59.7,2,2,0,0,552,404,148,523.2
2023-04-01T16:00,63.7,1,1,0,0,766,667,99,801.1
2023-04-01T17:00,66,7,0,11,0,809,712,97,937.5
2023-04-01T18:00,67.1,27,0,40,10,797,651,146,875.2
2023-04-01T19:00,69.4,88,0,97,99,735,588,147,830.6
2023-04-01T20:00,67.7,90,0,100,100,411,144,267,517.7
2023-04-01T21:00,58.9,94,6,98,98,92,0,92,87.9
2023-04-01T22:00,52.7,78,1,85,86,52,0,52,0
2023-04-01T23:00,48,59,17,39,66,62,18,44,48.8